"","LakeID","Year","warm","cold","mean","mixing_period"
"1","114",1979,156,99,12.1196598214286,57
"2","114",1980,149,84,10.13753890625,65
"3","114",1981,155,82,9.76041847222222,73
"4","114",1982,133,101,11.4424590322581,32
"5","114",1983,161,110,11.3049708,51
"6","114",1984,156,92,10.014039047619,64
"7","114",1985,174,82,13.567700989011,92
"8","114",1986,169,82,12.9113469767442,87
"9","114",1987,147,74,10.0642309722222,73
"10","114",1988,150,79,9.88599628571429,71
"11","114",1989,152,80,10.4861695774648,72
"12","114",1990,162,82,10.5927074683544,80
"13","114",1991,132,74,9.27027157894737,58
"14","114",1992,164,82,10.5033459259259,82
"15","114",1993,162,80,10.3250486419753,82
"16","114",1994,163,75,10.3620511494253,88
"17","114",1995,155,68,8.72309220930233,87
"18","114",1996,165,98,11.0335965151515,67
"19","114",1997,169,101,11.5533352238806,68
"20","114",1998,135,80,10.9430368518519,55
"21","114",1999,154,75,11.0730032051282,79
"22","114",2000,127,51,8.04470426666667,76
"23","114",2001,138,87,12.3208258,51
"24","114",2002,150,85,9.513293125,65
"25","114",2003,167,97,12.861952173913,70
"26","114",2004,132,75,9.48172625,57
"27","114",2005,154,79,11.0041887837838,75
"28","114",2006,146,82,10.717080952381,64
"29","114",2007,147,99,13.4836357446809,48
"30","114",2008,154,73,9.057228125,81
"31","114",2009,168,71,10.6039722916667,97
"32","114",2010,142,65,10.0456809210526,77
"33","114",2011,152,88,11.2027431746032,64
"34","114",2012,80,59,8.1810015,21
"35","114",2013,162,84,11.2632848051948,78
"36","114",2014,148,86,11.0267142622951,62
"37","114",2015,147,85,11.631166557377,62
"38","114",2016,145,64,9.215707375,81
"39","114",2017,160,76,12.0985639759036,84
"40","114",2018,144,107,13.1772813888889,37
"41","114",2019,174,69,11.2968563461538,105
"42","114",2020,145,64,7.581809375,81
"43","114",2021,140,65,9.29214986486486,75
"44","114",2022,130,72,7.1719898245614,58
"45","114",2023,150,76,10.1418354794521,74
"46","116",1979,156,98,12.0609154385965,58
"47","116",1980,151,75,9.26900413333333,76
"48","116",1981,155,79,11.0299541333333,76
"49","116",1982,133,100,11.4325225,33
"50","116",1983,161,87,9.04841054794521,74
"51","116",1984,156,82,8.94868123287671,74
"52","116",1985,111,66,5.96422113636364,45
"53","116",1986,169,80,13.0197065909091,89
"54","116",1987,147,74,10.1911848611111,73
"55","116",1988,150,79,9.894925,71
"56","116",1989,152,80,10.3839471830986,72
"57","116",1990,162,66,10.0042390526316,96
"58","116",1991,132,73,9.19856517241379,59
"59","116",1992,165,82,10.5942313414634,83
"60","116",1993,162,80,10.3487756790123,82
"61","116",1994,163,70,9.79249391304348,93
"62","116",1995,166,68,9.7819624742268,98
"63","116",1996,166,89,10.0196363157895,77
"64","116",1997,169,101,11.2887597014925,68
"65","116",1998,135,79,10.5731067272727,56
"66","116",1999,154,75,10.9480033333333,79
"67","116",2000,127,51,7.95095573333333,76
"68","116",2001,161,87,12.5049875342466,74
"69","116",2002,150,86,9.50460333333333,64
"70","116",2003,173,97,13.0494525333333,76
"71","116",2004,132,75,9.34472928571429,57
"72","116",2005,154,79,10.8924910810811,75
"73","116",2006,146,82,10.7669326984127,64
"74","116",2007,148,99,13.38900625,49
"75","116",2008,155,72,9.17067036585366,83
"76","116",2009,168,71,10.5642583333333,97
"77","116",2010,143,65,9.97658961038961,78
"78","116",2011,152,88,11.1176734920635,64
"79","116",2012,79,58,7.359545,21
"80","116",2013,138,84,8.82097,54
"81","116",2014,149,86,11.0263579032258,63
"82","116",2015,147,85,11.5056540983607,62
"83","116",2016,145,64,9.137094125,81
"84","116",2017,160,77,12.112592804878,83
"85","116",2018,144,97,10.6914504347826,47
"86","116",2019,175,69,11.2405586666667,106
"87","116",2020,145,63,7.44776358024691,82
"88","116",2021,139,65,9.07830835616438,74
"89","116",2022,131,72,7.54513620689655,59
"90","116",2023,150,76,10.1032016438356,74
"91","134",1979,190,101,12.8536681818182,89
"92","134",1980,175,88,11.7119047674419,87
"93","134",1981,163,84,9.09144448717949,79
"94","134",1982,185,102,13.8097943902439,83
"95","134",1983,163,110,10.09629,53
"96","134",1984,157,92,9.3421134375,65
"97","134",1985,183,82,12.7837889,101
"98","134",1986,175,83,12.394157032967,92
"99","134",1987,148,92,11.3406532727273,56
"100","134",1988,150,81,9.09222794117647,69
"101","134",1989,171,81,10.6182291011236,90
"102","134",1990,163,85,10.0452703896104,78
"103","134",1991,133,74,8.06491172413793,59
"104","134",1992,220,84,12.9722324444444,136
"105","134",1993,184,81,10.8762181372549,103
"106","134",1994,164,77,9.33488988372093,87
"107","134",1995,166,97,10.6149575,69
"108","134",1996,179,99,11.0947563291139,80
"109","134",1997,171,101,10.5542944927536,70
"110","134",1998,136,81,9.94066574074074,55
"111","134",1999,157,75,10.3270519753086,82
"112","134",2000,163,51,9.36633054054054,112
"113","134",2001,161,87,11.2503856164384,74
"114","134",2002,171,94,11.4941161842105,77
"115","134",2003,173,98,12.1911078378378,75
"116","134",2004,193,80,12.8102261607143,113
"117","134",2005,155,81,10.2276554794521,74
"118","134",2006,146,82,9.79421476190476,64
"119","134",2007,151,100,12.8679704,51
"120","134",2008,157,86,9.73607671428571,71
"121","134",2009,169,73,9.60823221052632,96
"122","134",2010,143,66,8.9530075,77
"123","134",2011,155,88,9.9448246969697,67
"124","134",2012,168,63,12.0717453846154,105
"125","134",2013,172,84,10.6913220689655,88
"126","134",2014,169,86,11.4538613414634,83
"127","134",2015,172,86,12.4579811764706,86
"128","134",2016,146,64,7.67544358024691,82
"129","134",2017,161,77,10.7173345783133,84
"130","134",2018,145,108,12.3832619444444,37
"131","134",2019,176,73,10.0672206862745,103
"132","134",2020,146,67,6.35391730769231,79
"133","134",2021,140,66,8.21164273972603,74
"134","134",2022,131,89,7.08117853658537,42
"135","134",2023,150,76,9.08511506849315,74
"136","135",1979,157,100,10.55533125,57
"137","135",1980,175,88,12.4297472093023,87
"138","135",1981,156,83,8.89785291666667,73
"139","135",1982,133,102,11.137163,31
"140","135",1983,161,110,10.5738764,51
"141","135",1984,156,92,9.65391968253968,64
"142","135",1985,175,82,13.1281569565217,93
"143","135",1986,169,83,12.3956534117647,86
"144","135",1987,148,92,12.0555672727273,56
"145","135",1988,150,80,9.54280173913043,70
"146","135",1989,153,81,10.0163112676056,72
"147","135",1990,162,85,10.5488977631579,77
"148","135",1991,132,75,8.86555892857143,57
"149","135",1992,165,85,10.4597450632911,80
"150","135",1993,162,81,9.879578625,81
"151","135",1994,163,77,10.1016130588235,86
"152","135",1995,166,68,9.19819989690722,98
"153","135",1996,166,98,10.5520792537313,68
"154","135",1997,170,101,11.1884388235294,69
"155","135",1998,136,80,10.6296856363636,56
"156","135",1999,155,75,10.8005606329114,80
"157","135",2000,162,51,10.1119036363636,111
"158","135",2001,161,87,12.1085831506849,74
"159","135",2002,160,86,10.310074109589,74
"160","135",2003,173,98,13.0565010810811,75
"161","135",2004,158,76,11.3243427160494,82
"162","135",2005,155,79,10.6442649333333,76
"163","135",2006,146,82,10.3460498412698,64
"164","135",2007,149,100,13.3109445833333,49
"165","135",2008,155,83,9.97705464788732,72
"166","135",2009,168,72,10.2457908421053,96
"167","135",2010,143,65,9.61944701298701,78
"168","135",2011,152,88,10.6092406349206,64
"169","135",2012,160,62,12.313692371134,98
"170","135",2013,164,85,11.0227894871795,79
"171","135",2014,149,86,10.5300120967742,63
"172","135",2015,158,85,11.8928388888889,73
"173","135",2016,145,64,8.59646925,81
"174","135",2017,160,77,11.5773412195122,83
"175","135",2018,145,108,13.1048344444444,37
"176","135",2019,175,70,10.8279181730769,105
"177","135",2020,146,66,7.32382873417721,80
"178","135",2021,140,66,8.98925301369863,74
"179","135",2022,131,88,7.92943333333333,43
"180","135",2023,150,76,9.6754401369863,74
"181","136",1979,156,98,12.0609154385965,58
"182","136",1980,151,75,9.26900413333333,76
"183","136",1981,155,79,11.0299541333333,76
"184","136",1982,133,100,11.4325225,33
"185","136",1983,161,87,9.04841054794521,74
"186","136",1984,156,82,8.94868123287671,74
"187","136",1985,111,66,5.96422113636364,45
"188","136",1986,169,80,13.0197065909091,89
"189","136",1987,147,74,10.1911848611111,73
"190","136",1988,150,79,9.894925,71
"191","136",1989,152,80,10.3839471830986,72
"192","136",1990,162,66,10.0042390526316,96
"193","136",1991,132,73,9.19856517241379,59
"194","136",1992,165,82,10.5942313414634,83
"195","136",1993,162,80,10.3487756790123,82
"196","136",1994,163,70,9.79249391304348,93
"197","136",1995,166,68,9.7819624742268,98
"198","136",1996,166,89,10.0196363157895,77
"199","136",1997,169,101,11.2887597014925,68
"200","136",1998,135,79,10.5731067272727,56
"201","136",1999,154,75,10.9480033333333,79
"202","136",2000,127,51,7.95095573333333,76
"203","136",2001,161,87,12.5049875342466,74
"204","136",2002,150,86,9.50460333333333,64
"205","136",2003,173,97,13.0494525333333,76
"206","136",2004,132,75,9.34472928571429,57
"207","136",2005,154,79,10.8924910810811,75
"208","136",2006,146,82,10.7669326984127,64
"209","136",2007,148,99,13.38900625,49
"210","136",2008,155,72,9.17067036585366,83
"211","136",2009,168,71,10.5642583333333,97
"212","136",2010,143,65,9.97658961038961,78
"213","136",2011,152,88,11.1176734920635,64
"214","136",2012,79,58,7.359545,21
"215","136",2013,138,84,8.82097,54
"216","136",2014,149,86,11.0263579032258,63
"217","136",2015,147,85,11.5056540983607,62
"218","136",2016,145,64,9.137094125,81
"219","136",2017,160,77,12.112592804878,83
"220","136",2018,144,97,10.6914504347826,47
"221","136",2019,175,69,11.2405586666667,106
"222","136",2020,145,63,7.44776358024691,82
"223","136",2021,139,65,9.07830835616438,74
"224","136",2022,131,72,7.54513620689655,59
"225","136",2023,150,76,10.1032016438356,74
"226","139",1979,157,100,10.55533125,57
"227","139",1980,175,88,12.4297472093023,87
"228","139",1981,156,83,8.89785291666667,73
"229","139",1982,133,102,11.137163,31
"230","139",1983,161,110,10.5738764,51
"231","139",1984,156,92,9.65391968253968,64
"232","139",1985,175,82,13.1281569565217,93
"233","139",1986,169,83,12.3956534117647,86
"234","139",1987,148,92,12.0555672727273,56
"235","139",1988,150,80,9.54280173913043,70
"236","139",1989,153,81,10.0163112676056,72
"237","139",1990,162,85,10.5488977631579,77
"238","139",1991,132,75,8.86555892857143,57
"239","139",1992,165,85,10.4597450632911,80
"240","139",1993,162,81,9.879578625,81
"241","139",1994,163,77,10.1016130588235,86
"242","139",1995,166,68,9.19819989690722,98
"243","139",1996,166,98,10.5520792537313,68
"244","139",1997,170,101,11.1884388235294,69
"245","139",1998,136,80,10.6296856363636,56
"246","139",1999,155,75,10.8005606329114,80
"247","139",2000,162,51,10.1119036363636,111
"248","139",2001,161,87,12.1085831506849,74
"249","139",2002,160,86,10.310074109589,74
"250","139",2003,173,98,13.0565010810811,75
"251","139",2004,158,76,11.3243427160494,82
"252","139",2005,155,79,10.6442649333333,76
"253","139",2006,146,82,10.3460498412698,64
"254","139",2007,149,100,13.3109445833333,49
"255","139",2008,155,83,9.97705464788732,72
"256","139",2009,168,72,10.2457908421053,96
"257","139",2010,143,65,9.61944701298701,78
"258","139",2011,152,88,10.6092406349206,64
"259","139",2012,160,62,12.313692371134,98
"260","139",2013,164,85,11.0227894871795,79
"261","139",2014,149,86,10.5300120967742,63
"262","139",2015,158,85,11.8928388888889,73
"263","139",2016,145,64,8.59646925,81
"264","139",2017,160,77,11.5773412195122,83
"265","139",2018,145,108,13.1048344444444,37
"266","139",2019,175,70,10.8279181730769,105
"267","139",2020,146,66,7.32382873417721,80
"268","139",2021,140,66,8.98925301369863,74
"269","139",2022,131,88,7.92943333333333,43
"270","139",2023,150,76,9.6754401369863,74
"271","26",1979,190,124,8.96698907692308,66
"272","26",1980,175,107,12.0504676119403,68
"273","26",1981,185,96,11.1192511363636,89
"274","26",1982,185,102,12.065987804878,83
"275","26",1983,173,110,10.4749927419355,63
"276","26",1984,193,101,10.9802272527473,92
"277","26",1985,NA,99,NA,NA
"278","26",1986,187,86,11.6198657,101
"279","26",1987,150,93,11.2692278571429,57
"280","26",1988,150,87,8.48664935483871,63
"281","26",1989,183,102,11.584838875,81
"282","26",1990,180,99,11.651389125,81
"283","26",1991,177,91,12.7397698823529,86
"284","26",1992,NA,105,NA,NA
"285","26",1993,223,94,12.286562578125,129
"286","26",1994,165,95,9.51084797101449,70
"287","26",1995,167,99,9.01775910447761,68
"288","26",1996,181,106,10.1698622972973,75
"289","26",1997,173,104,9.50931926470588,69
"290","26",1998,169,82,11.0672420930233,87
"291","26",1999,158,86,10.0882097183099,72
"292","26",2000,212,78,11.8476005263158,134
"293","26",2001,163,89,9.90407726027397,74
"294","26",2002,173,97,9.82342853333333,76
"295","26",2003,183,98,12.0844335714286,85
"296","26",2004,195,93,11.1007011881188,102
"297","26",2005,157,85,9.49369183098591,72
"298","26",2006,147,86,8.65195633333333,61
"299","26",2007,163,101,13.0869363934426,62
"300","26",2008,191,92,11.1984462244898,99
"301","26",2009,170,98,10.1911776056338,72
"302","26",2010,142,65,7.79681131578947,77
"303","26",2011,180,90,10.5647612359551,90
"304","26",2012,169,69,10.3365062626263,100
"305","26",2013,173,108,11.72683296875,65
"306","26",2014,177,107,12.4822436231884,70
"307","26",2015,193,88,12.0730156730769,105
"308","26",2016,188,101,13.5053260465116,87
"309","26",2017,161,79,8.73033222222222,82
"310","26",2018,145,109,11.0270794285714,36
"311","26",2019,178,103,10.9125014864865,75
"312","26",2020,179,111,12.2427250746269,68
"313","26",2021,155,77,8.45442818181818,78
"314","26",2022,169,109,12.1510822033898,60
"315","26",2023,151,96,10.0944535185185,55
"316","27",1979,190,124,8.96698907692308,66
"317","27",1980,175,107,12.0504676119403,68
"318","27",1981,185,96,11.1192511363636,89
"319","27",1982,185,102,12.065987804878,83
"320","27",1983,173,110,10.4749927419355,63
"321","27",1984,193,101,10.9802272527473,92
"322","27",1985,NA,99,NA,NA
"323","27",1986,187,86,11.6198657,101
"324","27",1987,150,93,11.2692278571429,57
"325","27",1988,150,87,8.48664935483871,63
"326","27",1989,183,102,11.584838875,81
"327","27",1990,180,99,11.651389125,81
"328","27",1991,177,91,12.7397698823529,86
"329","27",1992,NA,105,NA,NA
"330","27",1993,223,94,12.286562578125,129
"331","27",1994,165,95,9.51084797101449,70
"332","27",1995,167,99,9.01775910447761,68
"333","27",1996,181,106,10.1698622972973,75
"334","27",1997,173,104,9.50931926470588,69
"335","27",1998,169,82,11.0672420930233,87
"336","27",1999,158,86,10.0882097183099,72
"337","27",2000,212,78,11.8476005263158,134
"338","27",2001,163,89,9.90407726027397,74
"339","27",2002,173,97,9.82342853333333,76
"340","27",2003,183,98,12.0844335714286,85
"341","27",2004,195,93,11.1007011881188,102
"342","27",2005,157,85,9.49369183098591,72
"343","27",2006,147,86,8.65195633333333,61
"344","27",2007,163,101,13.0869363934426,62
"345","27",2008,191,92,11.1984462244898,99
"346","27",2009,170,98,10.1911776056338,72
"347","27",2010,142,65,7.79681131578947,77
"348","27",2011,180,90,10.5647612359551,90
"349","27",2012,169,69,10.3365062626263,100
"350","27",2013,173,108,11.72683296875,65
"351","27",2014,177,107,12.4822436231884,70
"352","27",2015,193,88,12.0730156730769,105
"353","27",2016,188,101,13.5053260465116,87
"354","27",2017,161,79,8.73033222222222,82
"355","27",2018,145,109,11.0270794285714,36
"356","27",2019,178,103,10.9125014864865,75
"357","27",2020,179,111,12.2427250746269,68
"358","27",2021,155,77,8.45442818181818,78
"359","27",2022,169,109,12.1510822033898,60
"360","27",2023,151,96,10.0944535185185,55
"361","28",1979,190,124,8.96698907692308,66
"362","28",1980,175,107,12.0504676119403,68
"363","28",1981,185,96,11.1192511363636,89
"364","28",1982,185,102,12.065987804878,83
"365","28",1983,173,110,10.4749927419355,63
"366","28",1984,193,101,10.9802272527473,92
"367","28",1985,NA,99,NA,NA
"368","28",1986,187,86,11.6198657,101
"369","28",1987,150,93,11.2692278571429,57
"370","28",1988,150,87,8.48664935483871,63
"371","28",1989,183,102,11.584838875,81
"372","28",1990,180,99,11.651389125,81
"373","28",1991,177,91,12.7397698823529,86
"374","28",1992,NA,105,NA,NA
"375","28",1993,223,94,12.286562578125,129
"376","28",1994,165,95,9.51084797101449,70
"377","28",1995,167,99,9.01775910447761,68
"378","28",1996,181,106,10.1698622972973,75
"379","28",1997,173,104,9.50931926470588,69
"380","28",1998,169,82,11.0672420930233,87
"381","28",1999,158,86,10.0882097183099,72
"382","28",2000,212,78,11.8476005263158,134
"383","28",2001,163,89,9.90407726027397,74
"384","28",2002,173,97,9.82342853333333,76
"385","28",2003,183,98,12.0844335714286,85
"386","28",2004,195,93,11.1007011881188,102
"387","28",2005,157,85,9.49369183098591,72
"388","28",2006,147,86,8.65195633333333,61
"389","28",2007,163,101,13.0869363934426,62
"390","28",2008,191,92,11.1984462244898,99
"391","28",2009,170,98,10.1911776056338,72
"392","28",2010,142,65,7.79681131578947,77
"393","28",2011,180,90,10.5647612359551,90
"394","28",2012,169,69,10.3365062626263,100
"395","28",2013,173,108,11.72683296875,65
"396","28",2014,177,107,12.4822436231884,70
"397","28",2015,193,88,12.0730156730769,105
"398","28",2016,188,101,13.5053260465116,87
"399","28",2017,161,79,8.73033222222222,82
"400","28",2018,145,109,11.0270794285714,36
"401","28",2019,178,103,10.9125014864865,75
"402","28",2020,179,111,12.2427250746269,68
"403","28",2021,155,77,8.45442818181818,78
"404","28",2022,169,109,12.1510822033898,60
"405","28",2023,151,96,10.0944535185185,55
"406","29",1979,190,124,8.96698907692308,66
"407","29",1980,175,107,12.0504676119403,68
"408","29",1981,185,96,11.1192511363636,89
"409","29",1982,185,102,12.065987804878,83
"410","29",1983,173,110,10.4749927419355,63
"411","29",1984,193,101,10.9802272527473,92
"412","29",1985,NA,99,NA,NA
"413","29",1986,187,86,11.6198657,101
"414","29",1987,150,93,11.2692278571429,57
"415","29",1988,150,87,8.48664935483871,63
"416","29",1989,183,102,11.584838875,81
"417","29",1990,180,99,11.651389125,81
"418","29",1991,177,91,12.7397698823529,86
"419","29",1992,NA,105,NA,NA
"420","29",1993,223,94,12.286562578125,129
"421","29",1994,165,95,9.51084797101449,70
"422","29",1995,167,99,9.01775910447761,68
"423","29",1996,181,106,10.1698622972973,75
"424","29",1997,173,104,9.50931926470588,69
"425","29",1998,169,82,11.0672420930233,87
"426","29",1999,158,86,10.0882097183099,72
"427","29",2000,212,78,11.8476005263158,134
"428","29",2001,163,89,9.90407726027397,74
"429","29",2002,173,97,9.82342853333333,76
"430","29",2003,183,98,12.0844335714286,85
"431","29",2004,195,93,11.1007011881188,102
"432","29",2005,157,85,9.49369183098591,72
"433","29",2006,147,86,8.65195633333333,61
"434","29",2007,163,101,13.0869363934426,62
"435","29",2008,191,92,11.1984462244898,99
"436","29",2009,170,98,10.1911776056338,72
"437","29",2010,142,65,7.79681131578947,77
"438","29",2011,180,90,10.5647612359551,90
"439","29",2012,169,69,10.3365062626263,100
"440","29",2013,173,108,11.72683296875,65
"441","29",2014,177,107,12.4822436231884,70
"442","29",2015,193,88,12.0730156730769,105
"443","29",2016,188,101,13.5053260465116,87
"444","29",2017,161,79,8.73033222222222,82
"445","29",2018,145,109,11.0270794285714,36
"446","29",2019,178,103,10.9125014864865,75
"447","29",2020,179,111,12.2427250746269,68
"448","29",2021,155,77,8.45442818181818,78
"449","29",2022,169,109,12.1510822033898,60
"450","29",2023,151,96,10.0944535185185,55
"451","30",1979,158,98,12.0230222033898,60
"452","30",1980,148,76,9.14890535211268,72
"453","30",1981,156,78,11.0162650649351,78
"454","30",1982,134,100,11.0547009090909,34
"455","30",1983,161,88,8.95154513888889,73
"456","30",1984,156,84,9.22701070422535,72
"457","30",1985,175,67,11.8713206542056,108
"458","30",1986,149,80,10.9579877941176,69
"459","30",1987,148,92,12.6011649090909,56
"460","30",1988,150,79,9.69023728571429,71
"461","30",1989,153,81,10.5349066197183,72
"462","30",1990,162,85,10.7890297368421,77
"463","30",1991,132,73,8.57558534482759,59
"464","30",1992,163,84,10.4735787179487,79
"465","30",1993,162,94,11.319323880597,68
"466","30",1994,163,70,9.60958,93
"467","30",1995,155,69,8.51357811764706,86
"468","30",1996,165,98,10.4861298484848,67
"469","30",1997,169,101,11.3981352238806,68
"470","30",1998,136,81,10.94544,55
"471","30",1999,155,74,10.790832,81
"472","30",2000,161,51,10.0467067889908,110
"473","30",2001,161,87,12.2208476712329,74
"474","30",2002,160,86,10.4413887671233,74
"475","30",2003,164,97,12.4359704545455,67
"476","30",2004,158,75,11.2204391463415,83
"477","30",2005,155,80,10.8455560810811,75
"478","30",2006,146,84,10.4104183606557,62
"479","30",2007,150,100,13.7173255102041,50
"480","30",2008,155,82,9.68079833333333,73
"481","30",2009,168,72,10.2521235789474,96
"482","30",2010,142,66,9.6732256,76
"483","30",2011,152,88,10.4926736507936,64
"484","30",2012,160,63,12.574135625,97
"485","30",2013,163,85,10.5934912987013,78
"486","30",2014,149,86,10.1407737096774,63
"487","30",2015,158,86,11.9817814084507,72
"488","30",2016,145,64,8.61482775,81
"489","30",2017,160,76,11.5146039759036,84
"490","30",2018,144,108,13.1656957142857,36
"491","30",2019,175,71,11.0402170873786,104
"492","30",2020,146,65,7.18480925,81
"493","30",2021,140,66,8.80378684931507,74
"494","30",2022,130,89,7.36635975,41
"495","30",2023,150,76,9.55632657534247,74
"496","31",1979,158,98,12.0230222033898,60
"497","31",1980,148,76,9.14890535211268,72
"498","31",1981,156,78,11.0162650649351,78
"499","31",1982,134,100,11.0547009090909,34
"500","31",1983,161,88,8.95154513888889,73
"501","31",1984,156,84,9.22701070422535,72
"502","31",1985,175,67,11.8713206542056,108
"503","31",1986,149,80,10.9579877941176,69
"504","31",1987,148,92,12.6011649090909,56
"505","31",1988,150,79,9.69023728571429,71
"506","31",1989,153,81,10.5349066197183,72
"507","31",1990,162,85,10.7890297368421,77
"508","31",1991,132,73,8.57558534482759,59
"509","31",1992,163,84,10.4735787179487,79
"510","31",1993,162,94,11.319323880597,68
"511","31",1994,163,70,9.60958,93
"512","31",1995,155,69,8.51357811764706,86
"513","31",1996,165,98,10.4861298484848,67
"514","31",1997,169,101,11.3981352238806,68
"515","31",1998,136,81,10.94544,55
"516","31",1999,155,74,10.790832,81
"517","31",2000,161,51,10.0467067889908,110
"518","31",2001,161,87,12.2208476712329,74
"519","31",2002,160,86,10.4413887671233,74
"520","31",2003,164,97,12.4359704545455,67
"521","31",2004,158,75,11.2204391463415,83
"522","31",2005,155,80,10.8455560810811,75
"523","31",2006,146,84,10.4104183606557,62
"524","31",2007,150,100,13.7173255102041,50
"525","31",2008,155,82,9.68079833333333,73
"526","31",2009,168,72,10.2521235789474,96
"527","31",2010,142,66,9.6732256,76
"528","31",2011,152,88,10.4926736507936,64
"529","31",2012,160,63,12.574135625,97
"530","31",2013,163,85,10.5934912987013,78
"531","31",2014,149,86,10.1407737096774,63
"532","31",2015,158,86,11.9817814084507,72
"533","31",2016,145,64,8.61482775,81
"534","31",2017,160,76,11.5146039759036,84
"535","31",2018,144,108,13.1656957142857,36
"536","31",2019,175,71,11.0402170873786,104
"537","31",2020,146,65,7.18480925,81
"538","31",2021,140,66,8.80378684931507,74
"539","31",2022,130,89,7.36635975,41
"540","31",2023,150,76,9.55632657534247,74
"541","32",1979,157,98,11.9100437931034,59
"542","32",1980,148,76,9.09850901408451,72
"543","32",1981,156,79,11.1033177631579,77
"544","32",1982,133,100,11.0531271875,33
"545","32",1983,161,88,8.84108513888889,73
"546","32",1984,156,87,9.56720735294118,69
"547","32",1985,175,67,11.8158294392523,108
"548","32",1986,149,81,11.1349629850746,68
"549","32",1987,148,92,12.4281527272727,56
"550","32",1988,150,80,9.91746217391304,70
"551","32",1989,153,81,10.464703943662,72
"552","32",1990,115,85,6.09374034482759,30
"553","32",1991,132,74,8.86881877192982,58
"554","32",1992,164,83,10.470127,81
"555","32",1993,162,81,9.920301875,81
"556","32",1994,163,70,9.57671554347826,93
"557","32",1995,155,69,8.51826552941177,86
"558","32",1996,165,98,10.5030568181818,67
"559","32",1997,170,101,11.4185627941176,69
"560","32",1998,136,81,10.9813190740741,55
"561","32",1999,155,74,10.80059725,81
"562","32",2000,161,51,10.1304223853211,110
"563","32",2001,161,87,12.3460610958904,74
"564","32",2002,150,86,9.31871619047619,64
"565","32",2003,167,97,12.70774,70
"566","32",2004,158,76,11.4778922222222,82
"567","32",2005,155,80,10.9518693243243,75
"568","32",2006,146,83,10.4946790322581,63
"569","32",2007,149,100,13.5959379166667,49
"570","32",2008,155,82,9.85679638888889,73
"571","32",2009,168,72,10.3256434736842,96
"572","32",2010,142,66,9.76666306666667,76
"573","32",2011,152,88,10.670129047619,64
"574","32",2012,147,63,11.914598313253,84
"575","32",2013,163,85,10.806052987013,78
"576","32",2014,149,86,10.4922101612903,63
"577","32",2015,158,86,12.1768729577465,72
"578","32",2016,145,64,8.74803125,81
"579","32",2017,160,76,11.5330524096386,84
"580","32",2018,144,108,13.147168,36
"581","32",2019,175,70,10.9510396153846,105
"582","32",2020,145,65,7.11937949367089,80
"583","32",2021,140,66,8.98486616438356,74
"584","32",2022,130,89,7.54995425,41
"585","32",2023,150,76,9.75677602739726,74
"586","33",1979,190,122,8.6590623880597,68
"587","33",1980,175,106,11.0088302941176,69
"588","33",1981,185,95,10.887822247191,90
"589","33",1982,185,102,12.1575462195122,83
"590","33",1983,173,109,10.4955087301587,64
"591","33",1984,193,101,11.1600013186813,92
"592","33",1985,218,98,14.3910457983193,120
"593","33",1986,187,86,11.8441623,101
"594","33",1987,150,93,11.4404051785714,57
"595","33",1988,150,86,8.44087063492064,64
"596","33",1989,173,102,10.8133124285714,71
"597","33",1990,179,99,11.7368237974684,80
"598","33",1991,151,91,10.7587662711864,60
"599","33",1992,NA,105,NA,NA
"600","33",1993,222,94,12.3697165354331,128
"601","33",1994,165,95,9.64943579710145,70
"602","33",1995,167,98,9.07504720588235,69
"603","33",1996,181,106,10.41944,75
"604","33",1997,173,104,9.77459911764706,69
"605","33",1998,169,82,11.2486558139535,87
"606","33",1999,158,85,10.2323115277778,73
"607","33",2000,193,78,11.1809405263158,115
"608","33",2001,163,89,9.92762178082192,74
"609","33",2002,173,97,9.98790786666667,76
"610","33",2003,183,98,12.1720444047619,85
"611","33",2004,194,93,11.192073,101
"612","33",2005,157,85,9.62826464788732,72
"613","33",2006,147,86,8.765628,61
"614","33",2007,163,101,13.0795072131148,62
"615","33",2008,191,92,11.2620621428571,99
"616","33",2009,170,98,10.4287438028169,72
"617","33",2010,142,66,7.95447573333333,76
"618","33",2011,180,90,10.6927458426966,90
"619","33",2012,169,69,10.4837593939394,100
"620","33",2013,173,108,11.7973890625,65
"621","33",2014,177,107,12.605091884058,70
"622","33",2015,193,88,12.2332463461538,105
"623","33",2016,188,101,13.6859224418605,87
"624","33",2017,161,78,8.90568109756098,83
"625","33",2018,145,109,11.0960525714286,36
"626","33",2019,178,103,11.0351794594595,75
"627","33",2020,179,109,12.1350063768116,70
"628","33",2021,155,76,8.5075958974359,79
"629","33",2022,169,108,12.1270781666667,61
"630","33",2023,151,96,10.0972024074074,55
"631","34",1979,190,122,8.6590623880597,68
"632","34",1980,175,106,11.0088302941176,69
"633","34",1981,185,95,10.887822247191,90
"634","34",1982,185,102,12.1575462195122,83
"635","34",1983,173,109,10.4955087301587,64
"636","34",1984,193,101,11.1600013186813,92
"637","34",1985,218,98,14.3910457983193,120
"638","34",1986,187,86,11.8441623,101
"639","34",1987,150,93,11.4404051785714,57
"640","34",1988,150,86,8.44087063492064,64
"641","34",1989,173,102,10.8133124285714,71
"642","34",1990,179,99,11.7368237974684,80
"643","34",1991,151,91,10.7587662711864,60
"644","34",1992,NA,105,NA,NA
"645","34",1993,222,94,12.3697165354331,128
"646","34",1994,165,95,9.64943579710145,70
"647","34",1995,167,98,9.07504720588235,69
"648","34",1996,181,106,10.41944,75
"649","34",1997,173,104,9.77459911764706,69
"650","34",1998,169,82,11.2486558139535,87
"651","34",1999,158,85,10.2323115277778,73
"652","34",2000,193,78,11.1809405263158,115
"653","34",2001,163,89,9.92762178082192,74
"654","34",2002,173,97,9.98790786666667,76
"655","34",2003,183,98,12.1720444047619,85
"656","34",2004,194,93,11.192073,101
"657","34",2005,157,85,9.62826464788732,72
"658","34",2006,147,86,8.765628,61
"659","34",2007,163,101,13.0795072131148,62
"660","34",2008,191,92,11.2620621428571,99
"661","34",2009,170,98,10.4287438028169,72
"662","34",2010,142,66,7.95447573333333,76
"663","34",2011,180,90,10.6927458426966,90
"664","34",2012,169,69,10.4837593939394,100
"665","34",2013,173,108,11.7973890625,65
"666","34",2014,177,107,12.605091884058,70
"667","34",2015,193,88,12.2332463461538,105
"668","34",2016,188,101,13.6859224418605,87
"669","34",2017,161,78,8.90568109756098,83
"670","34",2018,145,109,11.0960525714286,36
"671","34",2019,178,103,11.0351794594595,75
"672","34",2020,179,109,12.1350063768116,70
"673","34",2021,155,76,8.5075958974359,79
"674","34",2022,169,108,12.1270781666667,61
"675","34",2023,151,96,10.0972024074074,55
"676","35",1979,190,122,8.6590623880597,68
"677","35",1980,175,106,11.0088302941176,69
"678","35",1981,185,95,10.887822247191,90
"679","35",1982,185,102,12.1575462195122,83
"680","35",1983,173,109,10.4955087301587,64
"681","35",1984,193,101,11.1600013186813,92
"682","35",1985,218,98,14.3910457983193,120
"683","35",1986,187,86,11.8441623,101
"684","35",1987,150,93,11.4404051785714,57
"685","35",1988,150,86,8.44087063492064,64
"686","35",1989,173,102,10.8133124285714,71
"687","35",1990,179,99,11.7368237974684,80
"688","35",1991,151,91,10.7587662711864,60
"689","35",1992,NA,105,NA,NA
"690","35",1993,222,94,12.3697165354331,128
"691","35",1994,165,95,9.64943579710145,70
"692","35",1995,167,98,9.07504720588235,69
"693","35",1996,181,106,10.41944,75
"694","35",1997,173,104,9.77459911764706,69
"695","35",1998,169,82,11.2486558139535,87
"696","35",1999,158,85,10.2323115277778,73
"697","35",2000,193,78,11.1809405263158,115
"698","35",2001,163,89,9.92762178082192,74
"699","35",2002,173,97,9.98790786666667,76
"700","35",2003,183,98,12.1720444047619,85
"701","35",2004,194,93,11.192073,101
"702","35",2005,157,85,9.62826464788732,72
"703","35",2006,147,86,8.765628,61
"704","35",2007,163,101,13.0795072131148,62
"705","35",2008,191,92,11.2620621428571,99
"706","35",2009,170,98,10.4287438028169,72
"707","35",2010,142,66,7.95447573333333,76
"708","35",2011,180,90,10.6927458426966,90
"709","35",2012,169,69,10.4837593939394,100
"710","35",2013,173,108,11.7973890625,65
"711","35",2014,177,107,12.605091884058,70
"712","35",2015,193,88,12.2332463461538,105
"713","35",2016,188,101,13.6859224418605,87
"714","35",2017,161,78,8.90568109756098,83
"715","35",2018,145,109,11.0960525714286,36
"716","35",2019,178,103,11.0351794594595,75
"717","35",2020,179,109,12.1350063768116,70
"718","35",2021,155,76,8.5075958974359,79
"719","35",2022,169,108,12.1270781666667,61
"720","35",2023,151,96,10.0972024074074,55
"721","36",1979,157,86,10.4497701428571,71
"722","36",1980,148,76,9.27918676056338,72
"723","36",1981,155,78,11.282565,77
"724","36",1982,134,100,11.2010081818182,34
"725","36",1983,161,87,9.02336780821918,74
"726","36",1984,156,84,9.26893436619718,72
"727","36",1985,174,66,11.857508411215,108
"728","36",1986,149,78,10.2135245714286,71
"729","36",1987,148,92,12.7532950909091,56
"730","36",1988,150,79,9.87171114285714,71
"731","36",1989,152,81,10.601813,71
"732","36",1990,162,85,10.9877342105263,77
"733","36",1991,132,74,9.0759198245614,58
"734","36",1992,163,82,10.418295375,81
"735","36",1993,162,81,10.135242375,81
"736","36",1994,163,70,9.88505456521739,93
"737","36",1995,155,68,8.66613255813954,87
"738","36",1996,165,98,10.8122425757576,67
"739","36",1997,169,101,11.5448232835821,68
"740","36",1998,136,80,10.9471570909091,56
"741","36",1999,155,74,10.900401625,81
"742","36",2000,161,51,10.3392811926606,110
"743","36",2001,160,87,12.4042884722222,73
"744","36",2002,150,85,9.440783125,65
"745","36",2003,164,97,12.5845263636364,67
"746","36",2004,158,75,11.6486980487805,83
"747","36",2005,155,80,11.0897491891892,75
"748","36",2006,146,83,10.4993406451613,63
"749","36",2007,149,100,13.7420964583333,49
"750","36",2008,155,74,9.023485375,81
"751","36",2009,168,72,10.5884727368421,96
"752","36",2010,142,66,9.8611416,76
"753","36",2011,152,88,10.8809423809524,64
"754","36",2012,160,63,12.8844384375,97
"755","36",2013,163,85,10.9771153246753,78
"756","36",2014,148,85,10.3404056451613,63
"757","36",2015,157,86,12.2407205714286,71
"758","36",2016,145,64,8.90232775,81
"759","36",2017,160,76,11.9153939759036,84
"760","36",2018,144,107,13.1275838888889,37
"761","36",2019,158,70,10.0124108045977,88
"762","36",2020,146,65,7.584320125,81
"763","36",2021,140,66,8.89785808219178,74
"764","36",2022,130,88,7.56924073170732,42
"765","36",2023,150,76,9.7925202739726,74
"766","WI-013038",1979,168,99,12.6996633823529,69
"767","WI-013038",1980,147,84,9.84830822580645,63
"768","WI-013038",1981,162,78,11.2585879518072,84
"769","WI-013038",1982,182,100,13.9537039506173,82
"770","WI-013038",1983,162,88,8.7065195890411,74
"771","WI-013038",1984,157,87,9.5942431884058,70
"772","WI-013038",1985,175,70,11.6532527884615,105
"773","WI-013038",1986,148,82,10.8541835384615,66
"774","WI-013038",1987,148,92,12.6905110909091,56
"775","WI-013038",1988,150,81,9.86026558823529,69
"776","WI-013038",1989,171,82,11.3909880681818,89
"777","WI-013038",1990,162,85,10.6065669736842,77
"778","WI-013038",1991,132,75,8.02083392857143,57
"779","WI-013038",1992,163,84,10.2407067948718,79
"780","WI-013038",1993,174,81,10.6844690217391,93
"781","WI-013038",1994,164,75,9.92327102272727,89
"782","WI-013038",1995,154,69,7.92162083333333,85
"783","WI-013038",1996,165,100,10.50882921875,65
"784","WI-013038",1997,170,101,11.5010539705882,69
"785","WI-013038",1998,136,81,11.0297853703704,55
"786","WI-013038",1999,155,74,10.787706875,81
"787","WI-013038",2000,161,51,9.60763009174312,110
"788","WI-013038",2001,161,88,11.8584063888889,73
"789","WI-013038",2002,160,94,10.7891876923077,66
"790","WI-013038",2003,165,97,12.5236743283582,68
"791","WI-013038",2004,158,81,11.2344043421053,77
"792","WI-013038",2005,154,82,10.774838028169,72
"793","WI-013038",2006,146,84,10.0965090163934,62
"794","WI-013038",2007,151,100,13.8118768,51
"795","WI-013038",2008,157,83,9.67797438356164,74
"796","WI-013038",2009,168,73,10.1431508510638,95
"797","WI-013038",2010,142,66,9.46874666666667,76
"798","WI-013038",2011,153,88,10.214958125,65
"799","WI-013038",2012,160,66,12.6202133333333,94
"800","WI-013038",2013,164,93,11.3045184285714,71
"801","WI-013038",2014,149,87,9.28672737704918,62
"802","WI-013038",2015,167,86,12.47896225,81
"803","WI-013038",2016,145,64,8.17947725,81
"804","WI-013038",2017,157,76,10.83269925,81
"805","WI-013038",2018,144,108,12.9105614285714,36
"806","WI-013038",2019,158,79,9.77801974358974,79
"807","WI-013038",2020,146,68,6.68698792207792,78
"808","WI-013038",2021,140,66,8.46217780821918,74
"809","WI-013038",2022,130,89,6.7985865,41
"810","WI-013038",2023,150,79,9.78203571428571,71
"811","WI-033140",1979,190,100,12.1174782022472,90
"812","WI-033140",1980,146,88,9.25487421052632,58
"813","WI-033140",1981,181,79,11.5733696039604,102
"814","WI-033140",1982,184,101,12.8438742682927,83
"815","WI-033140",1983,172,108,11.3361257142857,64
"816","WI-033140",1984,172,90,10.7351412345679,82
"817","WI-033140",1985,185,92,13.3659731521739,93
"818","WI-033140",1986,170,84,11.6272621176471,86
"819","WI-033140",1987,149,92,12.2138182142857,57
"820","WI-033140",1988,150,84,9.39989569230769,66
"821","WI-033140",1989,171,101,11.7567652173913,70
"822","WI-033140",1990,166,86,10.2215308860759,80
"823","WI-033140",1991,133,90,8.48121785714286,43
"824","WI-033140",1992,166,90,10.296874,76
"825","WI-033140",1993,186,83,10.4996391176471,103
"826","WI-033140",1994,165,88,9.96465078947368,77
"827","WI-033140",1995,166,98,10.0280944776119,68
"828","WI-033140",1996,165,103,9.58257360655738,62
"829","WI-033140",1997,172,101,10.6306668571429,71
"830","WI-033140",1998,166,81,11.7889313095238,85
"831","WI-033140",1999,157,81,10.6690518666667,76
"832","WI-033140",2000,185,77,11.4374248598131,108
"833","WI-033140",2001,162,89,10.6466491666667,73
"834","WI-033140",2002,160,96,9.50611603174603,64
"835","WI-033140",2003,166,98,11.8084431343284,68
"836","WI-033140",2004,193,82,11.6518012727273,111
"837","WI-033140",2005,156,85,9.792482,71
"838","WI-033140",2006,146,85,9.06140733333333,61
"839","WI-033140",2007,152,101,13.373379,51
"840","WI-033140",2008,187,91,11.6301202105263,96
"841","WI-033140",2009,168,95,10.9656591666667,73
"842","WI-033140",2010,142,66,8.6951012,76
"843","WI-033140",2011,156,89,9.47147227272727,67
"844","WI-033140",2012,159,68,10.7679065555556,91
"845","WI-033140",2013,172,95,10.4637265789474,77
"846","WI-033140",2014,149,95,8.37558924528302,54
"847","WI-033140",2015,191,86,13.0583809615385,105
"848","WI-033140",2016,164,98,12.4358103076923,66
"849","WI-033140",2017,159,77,9.77350888888889,82
"850","WI-033140",2018,144,109,11.9959911764706,35
"851","WI-033140",2019,177,87,10.6412805617978,90
"852","WI-033140",2020,171,107,12.4006352380952,64
"853","WI-033140",2021,141,68,7.17171222222222,73
"854","WI-033140",2022,167,107,12.7977605084746,60
"855","WI-033140",2023,151,94,10.5752957142857,57
"856","WI-033142",1979,190,100,12.1174782022472,90
"857","WI-033142",1980,146,88,9.25487421052632,58
"858","WI-033142",1981,181,79,11.5733696039604,102
"859","WI-033142",1982,184,101,12.8438742682927,83
"860","WI-033142",1983,172,108,11.3361257142857,64
"861","WI-033142",1984,172,90,10.7351412345679,82
"862","WI-033142",1985,185,92,13.3659731521739,93
"863","WI-033142",1986,170,84,11.6272621176471,86
"864","WI-033142",1987,149,92,12.2138182142857,57
"865","WI-033142",1988,150,84,9.39989569230769,66
"866","WI-033142",1989,171,101,11.7567652173913,70
"867","WI-033142",1990,166,86,10.2215308860759,80
"868","WI-033142",1991,133,90,8.48121785714286,43
"869","WI-033142",1992,166,90,10.296874,76
"870","WI-033142",1993,186,83,10.4996391176471,103
"871","WI-033142",1994,165,88,9.96465078947368,77
"872","WI-033142",1995,166,98,10.0280944776119,68
"873","WI-033142",1996,165,103,9.58257360655738,62
"874","WI-033142",1997,172,101,10.6306668571429,71
"875","WI-033142",1998,166,81,11.7889313095238,85
"876","WI-033142",1999,157,81,10.6690518666667,76
"877","WI-033142",2000,185,77,11.4374248598131,108
"878","WI-033142",2001,162,89,10.6466491666667,73
"879","WI-033142",2002,160,96,9.50611603174603,64
"880","WI-033142",2003,166,98,11.8084431343284,68
"881","WI-033142",2004,193,82,11.6518012727273,111
"882","WI-033142",2005,156,85,9.792482,71
"883","WI-033142",2006,146,85,9.06140733333333,61
"884","WI-033142",2007,152,101,13.373379,51
"885","WI-033142",2008,187,91,11.6301202105263,96
"886","WI-033142",2009,168,95,10.9656591666667,73
"887","WI-033142",2010,142,66,8.6951012,76
"888","WI-033142",2011,156,89,9.47147227272727,67
"889","WI-033142",2012,159,68,10.7679065555556,91
"890","WI-033142",2013,172,95,10.4637265789474,77
"891","WI-033142",2014,149,95,8.37558924528302,54
"892","WI-033142",2015,191,86,13.0583809615385,105
"893","WI-033142",2016,164,98,12.4358103076923,66
"894","WI-033142",2017,159,77,9.77350888888889,82
"895","WI-033142",2018,144,109,11.9959911764706,35
"896","WI-033142",2019,177,87,10.6412805617978,90
"897","WI-033142",2020,171,107,12.4006352380952,64
"898","WI-033142",2021,141,68,7.17171222222222,73
"899","WI-033142",2022,167,107,12.7977605084746,60
"900","WI-033142",2023,151,94,10.5752957142857,57
"901","WI-033143",1979,189,100,12.51541375,89
"902","WI-033143",1980,145,87,9.28590070175439,58
"903","WI-033143",1981,178,79,11.6143573469388,99
"904","WI-033143",1982,184,101,13.2350707317073,83
"905","WI-033143",1983,172,107,11.348820625,65
"906","WI-033143",1984,172,84,10.3310493103448,88
"907","WI-033143",1985,184,74,11.8018085321101,110
"908","WI-033143",1986,149,83,10.1959201538462,66
"909","WI-033143",1987,149,92,12.5865855357143,57
"910","WI-033143",1988,150,84,9.64905338461539,66
"911","WI-033143",1989,170,100,11.6787156521739,70
"912","WI-033143",1990,166,86,10.3767913924051,80
"913","WI-033143",1991,133,75,7.17589473684211,58
"914","WI-033143",1992,164,85,9.50767064102564,79
"915","WI-033143",1993,186,83,10.7091218627451,103
"916","WI-033143",1994,165,88,10.2684128947368,77
"917","WI-033143",1995,166,98,10.2314525373134,68
"918","WI-033143",1996,165,102,9.67561629032258,63
"919","WI-033143",1997,171,101,10.7258295652174,70
"920","WI-033143",1998,166,81,11.9392289285714,85
"921","WI-033143",1999,157,76,10.09933525,81
"922","WI-033143",2000,185,77,11.7272904672897,108
"923","WI-033143",2001,162,89,10.8775515277778,73
"924","WI-033143",2002,160,96,9.8134080952381,64
"925","WI-033143",2003,166,98,12.0070205970149,68
"926","WI-033143",2004,193,81,11.8449085585586,112
"927","WI-033143",2005,155,84,10.2520555714286,71
"928","WI-033143",2006,146,85,9.36297066666667,61
"929","WI-033143",2007,152,101,13.6579102,51
"930","WI-033143",2008,186,91,11.7635920212766,95
"931","WI-033143",2009,167,91,10.5807416,76
"932","WI-033143",2010,142,66,8.7559348,76
"933","WI-033143",2011,156,89,9.61067727272727,67
"934","WI-033143",2012,159,68,11.5319678888889,91
"935","WI-033143",2013,171,95,10.4061585333333,76
"936","WI-033143",2014,148,95,8.53371442307692,53
"937","WI-033143",2015,175,86,12.1350727272727,89
"938","WI-033143",2016,163,98,12.4323303125,65
"939","WI-033143",2017,157,77,9.7754617721519,80
"940","WI-033143",2018,144,109,12.1598247058824,35
"941","WI-033143",2019,177,82,10.3884937234043,95
"942","WI-033143",2020,157,107,11.1714271428571,50
"943","WI-033143",2021,141,67,7.29728219178082,74
"944","WI-033143",2022,165,90,10.2784587837838,75
"945","WI-033143",2023,150,91,10.3722544827586,59
"946","WI-033159",1979,190,100,12.1174782022472,90
"947","WI-033159",1980,146,88,9.25487421052632,58
"948","WI-033159",1981,181,79,11.5733696039604,102
"949","WI-033159",1982,184,101,12.8438742682927,83
"950","WI-033159",1983,172,108,11.3361257142857,64
"951","WI-033159",1984,172,90,10.7351412345679,82
"952","WI-033159",1985,185,92,13.3659731521739,93
"953","WI-033159",1986,170,84,11.6272621176471,86
"954","WI-033159",1987,149,92,12.2138182142857,57
"955","WI-033159",1988,150,84,9.39989569230769,66
"956","WI-033159",1989,171,101,11.7567652173913,70
"957","WI-033159",1990,166,86,10.2215308860759,80
"958","WI-033159",1991,133,90,8.48121785714286,43
"959","WI-033159",1992,166,90,10.296874,76
"960","WI-033159",1993,186,83,10.4996391176471,103
"961","WI-033159",1994,165,88,9.96465078947368,77
"962","WI-033159",1995,166,98,10.0280944776119,68
"963","WI-033159",1996,165,103,9.58257360655738,62
"964","WI-033159",1997,172,101,10.6306668571429,71
"965","WI-033159",1998,166,81,11.7889313095238,85
"966","WI-033159",1999,157,81,10.6690518666667,76
"967","WI-033159",2000,185,77,11.4374248598131,108
"968","WI-033159",2001,162,89,10.6466491666667,73
"969","WI-033159",2002,160,96,9.50611603174603,64
"970","WI-033159",2003,166,98,11.8084431343284,68
"971","WI-033159",2004,193,82,11.6518012727273,111
"972","WI-033159",2005,156,85,9.792482,71
"973","WI-033159",2006,146,85,9.06140733333333,61
"974","WI-033159",2007,152,101,13.373379,51
"975","WI-033159",2008,187,91,11.6301202105263,96
"976","WI-033159",2009,168,95,10.9656591666667,73
"977","WI-033159",2010,142,66,8.6951012,76
"978","WI-033159",2011,156,89,9.47147227272727,67
"979","WI-033159",2012,159,68,10.7679065555556,91
"980","WI-033159",2013,172,95,10.4637265789474,77
"981","WI-033159",2014,149,95,8.37558924528302,54
"982","WI-033159",2015,191,86,13.0583809615385,105
"983","WI-033159",2016,164,98,12.4358103076923,66
"984","WI-033159",2017,159,77,9.77350888888889,82
"985","WI-033159",2018,144,109,11.9959911764706,35
"986","WI-033159",2019,177,87,10.6412805617978,90
"987","WI-033159",2020,171,107,12.4006352380952,64
"988","WI-033159",2021,141,68,7.17171222222222,73
"989","WI-033159",2022,167,107,12.7977605084746,60
"990","WI-033159",2023,151,94,10.5752957142857,57
"991","WI-033160",1979,190,99,12.1404636666667,91
"992","WI-033160",1980,144,87,9.15972517857143,57
"993","WI-033160",1981,181,79,11.6924132673267,102
"994","WI-033160",1982,184,100,12.8627856626506,84
"995","WI-033160",1983,172,108,11.4040820634921,64
"996","WI-033160",1984,172,89,10.6307726829268,83
"997","WI-033160",1985,185,77,11.7889180373832,108
"998","WI-033160",1986,169,83,11.4433541176471,86
"999","WI-033160",1987,149,92,12.5077635714286,57
"1000","WI-033160",1988,150,84,9.516482,66
"1001","WI-033160",1989,171,101,11.687245942029,70
"1002","WI-033160",1990,176,95,11.95667925,81
"1003","WI-033160",1991,133,75,6.97400333333333,58
"1004","WI-033160",1992,166,90,10.3398949333333,76
"1005","WI-033160",1993,206,83,11.9445082786885,123
"1006","WI-033160",1994,165,88,10.1689061842105,77
"1007","WI-033160",1995,166,98,10.0574795522388,68
"1008","WI-033160",1996,165,102,9.50185161290323,63
"1009","WI-033160",1997,172,101,10.7244172857143,71
"1010","WI-033160",1998,166,81,11.8039983333333,85
"1011","WI-033160",1999,157,81,10.5368646666667,76
"1012","WI-033160",2000,185,77,11.5385493457944,108
"1013","WI-033160",2001,162,89,10.7865144444444,73
"1014","WI-033160",2002,160,96,9.60606666666667,64
"1015","WI-033160",2003,166,98,11.8100753731343,68
"1016","WI-033160",2004,193,82,11.5482504545455,111
"1017","WI-033160",2005,156,85,10.3610078571429,71
"1018","WI-033160",2006,146,85,9.30724166666667,61
"1019","WI-033160",2007,163,101,14.2919818032787,62
"1020","WI-033160",2008,187,91,11.4967318947368,96
"1021","WI-033160",2009,167,95,10.95333,72
"1022","WI-033160",2010,142,66,8.52208013333333,76
"1023","WI-033160",2011,156,89,9.39938484848485,67
"1024","WI-033160",2012,159,68,10.7675588888889,91
"1025","WI-033160",2013,172,107,11.92366859375,65
"1026","WI-033160",2014,149,95,8.42157924528302,54
"1027","WI-033160",2015,175,86,11.9267098863636,89
"1028","WI-033160",2016,164,98,12.3789590769231,66
"1029","WI-033160",2017,159,77,9.87574617283951,82
"1030","WI-033160",2018,144,109,12.1400632352941,35
"1031","WI-033160",2019,177,83,10.2573705376344,94
"1032","WI-033160",2020,157,107,11.0180471428571,50
"1033","WI-033160",2021,141,68,7.12668208333333,73
"1034","WI-033160",2022,167,107,12.7131474576271,60
"1035","WI-033160",2023,151,91,10.2196293220339,60
"1036","WI-033161",1979,189,100,12.51541375,89
"1037","WI-033161",1980,145,87,9.28590070175439,58
"1038","WI-033161",1981,178,79,11.6143573469388,99
"1039","WI-033161",1982,184,101,13.2350707317073,83
"1040","WI-033161",1983,172,107,11.348820625,65
"1041","WI-033161",1984,172,84,10.3310493103448,88
"1042","WI-033161",1985,184,74,11.8018085321101,110
"1043","WI-033161",1986,149,83,10.1959201538462,66
"1044","WI-033161",1987,149,92,12.5865855357143,57
"1045","WI-033161",1988,150,84,9.64905338461539,66
"1046","WI-033161",1989,170,100,11.6787156521739,70
"1047","WI-033161",1990,166,86,10.3767913924051,80
"1048","WI-033161",1991,133,75,7.17589473684211,58
"1049","WI-033161",1992,164,85,9.50767064102564,79
"1050","WI-033161",1993,186,83,10.7091218627451,103
"1051","WI-033161",1994,165,88,10.2684128947368,77
"1052","WI-033161",1995,166,98,10.2314525373134,68
"1053","WI-033161",1996,165,102,9.67561629032258,63
"1054","WI-033161",1997,171,101,10.7258295652174,70
"1055","WI-033161",1998,166,81,11.9392289285714,85
"1056","WI-033161",1999,157,76,10.09933525,81
"1057","WI-033161",2000,185,77,11.7272904672897,108
"1058","WI-033161",2001,162,89,10.8775515277778,73
"1059","WI-033161",2002,160,96,9.8134080952381,64
"1060","WI-033161",2003,166,98,12.0070205970149,68
"1061","WI-033161",2004,193,81,11.8449085585586,112
"1062","WI-033161",2005,155,84,10.2520555714286,71
"1063","WI-033161",2006,146,85,9.36297066666667,61
"1064","WI-033161",2007,152,101,13.6579102,51
"1065","WI-033161",2008,186,91,11.7635920212766,95
"1066","WI-033161",2009,167,91,10.5807416,76
"1067","WI-033161",2010,142,66,8.7559348,76
"1068","WI-033161",2011,156,89,9.61067727272727,67
"1069","WI-033161",2012,159,68,11.5319678888889,91
"1070","WI-033161",2013,171,95,10.4061585333333,76
"1071","WI-033161",2014,148,95,8.53371442307692,53
"1072","WI-033161",2015,175,86,12.1350727272727,89
"1073","WI-033161",2016,163,98,12.4323303125,65
"1074","WI-033161",2017,157,77,9.7754617721519,80
"1075","WI-033161",2018,144,109,12.1598247058824,35
"1076","WI-033161",2019,177,82,10.3884937234043,95
"1077","WI-033161",2020,157,107,11.1714271428571,50
"1078","WI-033161",2021,141,67,7.29728219178082,74
"1079","WI-033161",2022,165,90,10.2784587837838,75
"1080","WI-033161",2023,150,91,10.3722544827586,59
"1081","WI-033171",1979,190,99,12.1404636666667,91
"1082","WI-033171",1980,144,87,9.15972517857143,57
"1083","WI-033171",1981,181,79,11.6924132673267,102
"1084","WI-033171",1982,184,100,12.8627856626506,84
"1085","WI-033171",1983,172,108,11.4040820634921,64
"1086","WI-033171",1984,172,89,10.6307726829268,83
"1087","WI-033171",1985,185,77,11.7889180373832,108
"1088","WI-033171",1986,169,83,11.4433541176471,86
"1089","WI-033171",1987,149,92,12.5077635714286,57
"1090","WI-033171",1988,150,84,9.516482,66
"1091","WI-033171",1989,171,101,11.687245942029,70
"1092","WI-033171",1990,176,95,11.95667925,81
"1093","WI-033171",1991,133,75,6.97400333333333,58
"1094","WI-033171",1992,166,90,10.3398949333333,76
"1095","WI-033171",1993,206,83,11.9445082786885,123
"1096","WI-033171",1994,165,88,10.1689061842105,77
"1097","WI-033171",1995,166,98,10.0574795522388,68
"1098","WI-033171",1996,165,102,9.50185161290323,63
"1099","WI-033171",1997,172,101,10.7244172857143,71
"1100","WI-033171",1998,166,81,11.8039983333333,85
"1101","WI-033171",1999,157,81,10.5368646666667,76
"1102","WI-033171",2000,185,77,11.5385493457944,108
"1103","WI-033171",2001,162,89,10.7865144444444,73
"1104","WI-033171",2002,160,96,9.60606666666667,64
"1105","WI-033171",2003,166,98,11.8100753731343,68
"1106","WI-033171",2004,193,82,11.5482504545455,111
"1107","WI-033171",2005,156,85,10.3610078571429,71
"1108","WI-033171",2006,146,85,9.30724166666667,61
"1109","WI-033171",2007,163,101,14.2919818032787,62
"1110","WI-033171",2008,187,91,11.4967318947368,96
"1111","WI-033171",2009,167,95,10.95333,72
"1112","WI-033171",2010,142,66,8.52208013333333,76
"1113","WI-033171",2011,156,89,9.39938484848485,67
"1114","WI-033171",2012,159,68,10.7675588888889,91
"1115","WI-033171",2013,172,107,11.92366859375,65
"1116","WI-033171",2014,149,95,8.42157924528302,54
"1117","WI-033171",2015,175,86,11.9267098863636,89
"1118","WI-033171",2016,164,98,12.3789590769231,66
"1119","WI-033171",2017,159,77,9.87574617283951,82
"1120","WI-033171",2018,144,109,12.1400632352941,35
"1121","WI-033171",2019,177,83,10.2573705376344,94
"1122","WI-033171",2020,157,107,11.0180471428571,50
"1123","WI-033171",2021,141,68,7.12668208333333,73
"1124","WI-033171",2022,167,107,12.7131474576271,60
"1125","WI-033171",2023,151,91,10.2196293220339,60
"1126","WI-033177",1979,190,99,12.1404636666667,91
"1127","WI-033177",1980,144,87,9.15972517857143,57
"1128","WI-033177",1981,181,79,11.6924132673267,102
"1129","WI-033177",1982,184,100,12.8627856626506,84
"1130","WI-033177",1983,172,108,11.4040820634921,64
"1131","WI-033177",1984,172,89,10.6307726829268,83
"1132","WI-033177",1985,185,77,11.7889180373832,108
"1133","WI-033177",1986,169,83,11.4433541176471,86
"1134","WI-033177",1987,149,92,12.5077635714286,57
"1135","WI-033177",1988,150,84,9.516482,66
"1136","WI-033177",1989,171,101,11.687245942029,70
"1137","WI-033177",1990,176,95,11.95667925,81
"1138","WI-033177",1991,133,75,6.97400333333333,58
"1139","WI-033177",1992,166,90,10.3398949333333,76
"1140","WI-033177",1993,206,83,11.9445082786885,123
"1141","WI-033177",1994,165,88,10.1689061842105,77
"1142","WI-033177",1995,166,98,10.0574795522388,68
"1143","WI-033177",1996,165,102,9.50185161290323,63
"1144","WI-033177",1997,172,101,10.7244172857143,71
"1145","WI-033177",1998,166,81,11.8039983333333,85
"1146","WI-033177",1999,157,81,10.5368646666667,76
"1147","WI-033177",2000,185,77,11.5385493457944,108
"1148","WI-033177",2001,162,89,10.7865144444444,73
"1149","WI-033177",2002,160,96,9.60606666666667,64
"1150","WI-033177",2003,166,98,11.8100753731343,68
"1151","WI-033177",2004,193,82,11.5482504545455,111
"1152","WI-033177",2005,156,85,10.3610078571429,71
"1153","WI-033177",2006,146,85,9.30724166666667,61
"1154","WI-033177",2007,163,101,14.2919818032787,62
"1155","WI-033177",2008,187,91,11.4967318947368,96
"1156","WI-033177",2009,167,95,10.95333,72
"1157","WI-033177",2010,142,66,8.52208013333333,76
"1158","WI-033177",2011,156,89,9.39938484848485,67
"1159","WI-033177",2012,159,68,10.7675588888889,91
"1160","WI-033177",2013,172,107,11.92366859375,65
"1161","WI-033177",2014,149,95,8.42157924528302,54
"1162","WI-033177",2015,175,86,11.9267098863636,89
"1163","WI-033177",2016,164,98,12.3789590769231,66
"1164","WI-033177",2017,159,77,9.87574617283951,82
"1165","WI-033177",2018,144,109,12.1400632352941,35
"1166","WI-033177",2019,177,83,10.2573705376344,94
"1167","WI-033177",2020,157,107,11.0180471428571,50
"1168","WI-033177",2021,141,68,7.12668208333333,73
"1169","WI-033177",2022,167,107,12.7131474576271,60
"1170","WI-033177",2023,151,91,10.2196293220339,60
"1171","WI-033184",1979,190,99,12.1404636666667,91
"1172","WI-033184",1980,144,87,9.15972517857143,57
"1173","WI-033184",1981,181,79,11.6924132673267,102
"1174","WI-033184",1982,184,100,12.8627856626506,84
"1175","WI-033184",1983,172,108,11.4040820634921,64
"1176","WI-033184",1984,172,89,10.6307726829268,83
"1177","WI-033184",1985,185,77,11.7889180373832,108
"1178","WI-033184",1986,169,83,11.4433541176471,86
"1179","WI-033184",1987,149,92,12.5077635714286,57
"1180","WI-033184",1988,150,84,9.516482,66
"1181","WI-033184",1989,171,101,11.687245942029,70
"1182","WI-033184",1990,176,95,11.95667925,81
"1183","WI-033184",1991,133,75,6.97400333333333,58
"1184","WI-033184",1992,166,90,10.3398949333333,76
"1185","WI-033184",1993,206,83,11.9445082786885,123
"1186","WI-033184",1994,165,88,10.1689061842105,77
"1187","WI-033184",1995,166,98,10.0574795522388,68
"1188","WI-033184",1996,165,102,9.50185161290323,63
"1189","WI-033184",1997,172,101,10.7244172857143,71
"1190","WI-033184",1998,166,81,11.8039983333333,85
"1191","WI-033184",1999,157,81,10.5368646666667,76
"1192","WI-033184",2000,185,77,11.5385493457944,108
"1193","WI-033184",2001,162,89,10.7865144444444,73
"1194","WI-033184",2002,160,96,9.60606666666667,64
"1195","WI-033184",2003,166,98,11.8100753731343,68
"1196","WI-033184",2004,193,82,11.5482504545455,111
"1197","WI-033184",2005,156,85,10.3610078571429,71
"1198","WI-033184",2006,146,85,9.30724166666667,61
"1199","WI-033184",2007,163,101,14.2919818032787,62
"1200","WI-033184",2008,187,91,11.4967318947368,96
"1201","WI-033184",2009,167,95,10.95333,72
"1202","WI-033184",2010,142,66,8.52208013333333,76
"1203","WI-033184",2011,156,89,9.39938484848485,67
"1204","WI-033184",2012,159,68,10.7675588888889,91
"1205","WI-033184",2013,172,107,11.92366859375,65
"1206","WI-033184",2014,149,95,8.42157924528302,54
"1207","WI-033184",2015,175,86,11.9267098863636,89
"1208","WI-033184",2016,164,98,12.3789590769231,66
"1209","WI-033184",2017,159,77,9.87574617283951,82
"1210","WI-033184",2018,144,109,12.1400632352941,35
"1211","WI-033184",2019,177,83,10.2573705376344,94
"1212","WI-033184",2020,157,107,11.0180471428571,50
"1213","WI-033184",2021,141,68,7.12668208333333,73
"1214","WI-033184",2022,167,107,12.7131474576271,60
"1215","WI-033184",2023,151,91,10.2196293220339,60
"1216","WI-033185",1979,189,100,12.51541375,89
"1217","WI-033185",1980,145,87,9.28590070175439,58
"1218","WI-033185",1981,178,79,11.6143573469388,99
"1219","WI-033185",1982,184,101,13.2350707317073,83
"1220","WI-033185",1983,172,107,11.348820625,65
"1221","WI-033185",1984,172,84,10.3310493103448,88
"1222","WI-033185",1985,184,74,11.8018085321101,110
"1223","WI-033185",1986,149,83,10.1959201538462,66
"1224","WI-033185",1987,149,92,12.5865855357143,57
"1225","WI-033185",1988,150,84,9.64905338461539,66
"1226","WI-033185",1989,170,100,11.6787156521739,70
"1227","WI-033185",1990,166,86,10.3767913924051,80
"1228","WI-033185",1991,133,75,7.17589473684211,58
"1229","WI-033185",1992,164,85,9.50767064102564,79
"1230","WI-033185",1993,186,83,10.7091218627451,103
"1231","WI-033185",1994,165,88,10.2684128947368,77
"1232","WI-033185",1995,166,98,10.2314525373134,68
"1233","WI-033185",1996,165,102,9.67561629032258,63
"1234","WI-033185",1997,171,101,10.7258295652174,70
"1235","WI-033185",1998,166,81,11.9392289285714,85
"1236","WI-033185",1999,157,76,10.09933525,81
"1237","WI-033185",2000,185,77,11.7272904672897,108
"1238","WI-033185",2001,162,89,10.8775515277778,73
"1239","WI-033185",2002,160,96,9.8134080952381,64
"1240","WI-033185",2003,166,98,12.0070205970149,68
"1241","WI-033185",2004,193,81,11.8449085585586,112
"1242","WI-033185",2005,155,84,10.2520555714286,71
"1243","WI-033185",2006,146,85,9.36297066666667,61
"1244","WI-033185",2007,152,101,13.6579102,51
"1245","WI-033185",2008,186,91,11.7635920212766,95
"1246","WI-033185",2009,167,91,10.5807416,76
"1247","WI-033185",2010,142,66,8.7559348,76
"1248","WI-033185",2011,156,89,9.61067727272727,67
"1249","WI-033185",2012,159,68,11.5319678888889,91
"1250","WI-033185",2013,171,95,10.4061585333333,76
"1251","WI-033185",2014,148,95,8.53371442307692,53
"1252","WI-033185",2015,175,86,12.1350727272727,89
"1253","WI-033185",2016,163,98,12.4323303125,65
"1254","WI-033185",2017,157,77,9.7754617721519,80
"1255","WI-033185",2018,144,109,12.1598247058824,35
"1256","WI-033185",2019,177,82,10.3884937234043,95
"1257","WI-033185",2020,157,107,11.1714271428571,50
"1258","WI-033185",2021,141,67,7.29728219178082,74
"1259","WI-033185",2022,165,90,10.2784587837838,75
"1260","WI-033185",2023,150,91,10.3722544827586,59
"1261","WI-033187",1979,189,100,12.51541375,89
"1262","WI-033187",1980,145,87,9.28590070175439,58
"1263","WI-033187",1981,178,79,11.6143573469388,99
"1264","WI-033187",1982,184,101,13.2350707317073,83
"1265","WI-033187",1983,172,107,11.348820625,65
"1266","WI-033187",1984,172,84,10.3310493103448,88
"1267","WI-033187",1985,184,74,11.8018085321101,110
"1268","WI-033187",1986,149,83,10.1959201538462,66
"1269","WI-033187",1987,149,92,12.5865855357143,57
"1270","WI-033187",1988,150,84,9.64905338461539,66
"1271","WI-033187",1989,170,100,11.6787156521739,70
"1272","WI-033187",1990,166,86,10.3767913924051,80
"1273","WI-033187",1991,133,75,7.17589473684211,58
"1274","WI-033187",1992,164,85,9.50767064102564,79
"1275","WI-033187",1993,186,83,10.7091218627451,103
"1276","WI-033187",1994,165,88,10.2684128947368,77
"1277","WI-033187",1995,166,98,10.2314525373134,68
"1278","WI-033187",1996,165,102,9.67561629032258,63
"1279","WI-033187",1997,171,101,10.7258295652174,70
"1280","WI-033187",1998,166,81,11.9392289285714,85
"1281","WI-033187",1999,157,76,10.09933525,81
"1282","WI-033187",2000,185,77,11.7272904672897,108
"1283","WI-033187",2001,162,89,10.8775515277778,73
"1284","WI-033187",2002,160,96,9.8134080952381,64
"1285","WI-033187",2003,166,98,12.0070205970149,68
"1286","WI-033187",2004,193,81,11.8449085585586,112
"1287","WI-033187",2005,155,84,10.2520555714286,71
"1288","WI-033187",2006,146,85,9.36297066666667,61
"1289","WI-033187",2007,152,101,13.6579102,51
"1290","WI-033187",2008,186,91,11.7635920212766,95
"1291","WI-033187",2009,167,91,10.5807416,76
"1292","WI-033187",2010,142,66,8.7559348,76
"1293","WI-033187",2011,156,89,9.61067727272727,67
"1294","WI-033187",2012,159,68,11.5319678888889,91
"1295","WI-033187",2013,171,95,10.4061585333333,76
"1296","WI-033187",2014,148,95,8.53371442307692,53
"1297","WI-033187",2015,175,86,12.1350727272727,89
"1298","WI-033187",2016,163,98,12.4323303125,65
"1299","WI-033187",2017,157,77,9.7754617721519,80
"1300","WI-033187",2018,144,109,12.1598247058824,35
"1301","WI-033187",2019,177,82,10.3884937234043,95
"1302","WI-033187",2020,157,107,11.1714271428571,50
"1303","WI-033187",2021,141,67,7.29728219178082,74
"1304","WI-033187",2022,165,90,10.2784587837838,75
"1305","WI-033187",2023,150,91,10.3722544827586,59
"1306","WI-033193",1979,189,100,12.51541375,89
"1307","WI-033193",1980,145,87,9.28590070175439,58
"1308","WI-033193",1981,178,79,11.6143573469388,99
"1309","WI-033193",1982,184,101,13.2350707317073,83
"1310","WI-033193",1983,172,107,11.348820625,65
"1311","WI-033193",1984,172,84,10.3310493103448,88
"1312","WI-033193",1985,184,74,11.8018085321101,110
"1313","WI-033193",1986,149,83,10.1959201538462,66
"1314","WI-033193",1987,149,92,12.5865855357143,57
"1315","WI-033193",1988,150,84,9.64905338461539,66
"1316","WI-033193",1989,170,100,11.6787156521739,70
"1317","WI-033193",1990,166,86,10.3767913924051,80
"1318","WI-033193",1991,133,75,7.17589473684211,58
"1319","WI-033193",1992,164,85,9.50767064102564,79
"1320","WI-033193",1993,186,83,10.7091218627451,103
"1321","WI-033193",1994,165,88,10.2684128947368,77
"1322","WI-033193",1995,166,98,10.2314525373134,68
"1323","WI-033193",1996,165,102,9.67561629032258,63
"1324","WI-033193",1997,171,101,10.7258295652174,70
"1325","WI-033193",1998,166,81,11.9392289285714,85
"1326","WI-033193",1999,157,76,10.09933525,81
"1327","WI-033193",2000,185,77,11.7272904672897,108
"1328","WI-033193",2001,162,89,10.8775515277778,73
"1329","WI-033193",2002,160,96,9.8134080952381,64
"1330","WI-033193",2003,166,98,12.0070205970149,68
"1331","WI-033193",2004,193,81,11.8449085585586,112
"1332","WI-033193",2005,155,84,10.2520555714286,71
"1333","WI-033193",2006,146,85,9.36297066666667,61
"1334","WI-033193",2007,152,101,13.6579102,51
"1335","WI-033193",2008,186,91,11.7635920212766,95
"1336","WI-033193",2009,167,91,10.5807416,76
"1337","WI-033193",2010,142,66,8.7559348,76
"1338","WI-033193",2011,156,89,9.61067727272727,67
"1339","WI-033193",2012,159,68,11.5319678888889,91
"1340","WI-033193",2013,171,95,10.4061585333333,76
"1341","WI-033193",2014,148,95,8.53371442307692,53
"1342","WI-033193",2015,175,86,12.1350727272727,89
"1343","WI-033193",2016,163,98,12.4323303125,65
"1344","WI-033193",2017,157,77,9.7754617721519,80
"1345","WI-033193",2018,144,109,12.1598247058824,35
"1346","WI-033193",2019,177,82,10.3884937234043,95
"1347","WI-033193",2020,157,107,11.1714271428571,50
"1348","WI-033193",2021,141,67,7.29728219178082,74
"1349","WI-033193",2022,165,90,10.2784587837838,75
"1350","WI-033193",2023,150,91,10.3722544827586,59
"1351","WI-033210",1979,189,100,12.51541375,89
"1352","WI-033210",1980,145,87,9.28590070175439,58
"1353","WI-033210",1981,178,79,11.6143573469388,99
"1354","WI-033210",1982,184,101,13.2350707317073,83
"1355","WI-033210",1983,172,107,11.348820625,65
"1356","WI-033210",1984,172,84,10.3310493103448,88
"1357","WI-033210",1985,184,74,11.8018085321101,110
"1358","WI-033210",1986,149,83,10.1959201538462,66
"1359","WI-033210",1987,149,92,12.5865855357143,57
"1360","WI-033210",1988,150,84,9.64905338461539,66
"1361","WI-033210",1989,170,100,11.6787156521739,70
"1362","WI-033210",1990,166,86,10.3767913924051,80
"1363","WI-033210",1991,133,75,7.17589473684211,58
"1364","WI-033210",1992,164,85,9.50767064102564,79
"1365","WI-033210",1993,186,83,10.7091218627451,103
"1366","WI-033210",1994,165,88,10.2684128947368,77
"1367","WI-033210",1995,166,98,10.2314525373134,68
"1368","WI-033210",1996,165,102,9.67561629032258,63
"1369","WI-033210",1997,171,101,10.7258295652174,70
"1370","WI-033210",1998,166,81,11.9392289285714,85
"1371","WI-033210",1999,157,76,10.09933525,81
"1372","WI-033210",2000,185,77,11.7272904672897,108
"1373","WI-033210",2001,162,89,10.8775515277778,73
"1374","WI-033210",2002,160,96,9.8134080952381,64
"1375","WI-033210",2003,166,98,12.0070205970149,68
"1376","WI-033210",2004,193,81,11.8449085585586,112
"1377","WI-033210",2005,155,84,10.2520555714286,71
"1378","WI-033210",2006,146,85,9.36297066666667,61
"1379","WI-033210",2007,152,101,13.6579102,51
"1380","WI-033210",2008,186,91,11.7635920212766,95
"1381","WI-033210",2009,167,91,10.5807416,76
"1382","WI-033210",2010,142,66,8.7559348,76
"1383","WI-033210",2011,156,89,9.61067727272727,67
"1384","WI-033210",2012,159,68,11.5319678888889,91
"1385","WI-033210",2013,171,95,10.4061585333333,76
"1386","WI-033210",2014,148,95,8.53371442307692,53
"1387","WI-033210",2015,175,86,12.1350727272727,89
"1388","WI-033210",2016,163,98,12.4323303125,65
"1389","WI-033210",2017,157,77,9.7754617721519,80
"1390","WI-033210",2018,144,109,12.1598247058824,35
"1391","WI-033210",2019,177,82,10.3884937234043,95
"1392","WI-033210",2020,157,107,11.1714271428571,50
"1393","WI-033210",2021,141,67,7.29728219178082,74
"1394","WI-033210",2022,165,90,10.2784587837838,75
"1395","WI-033210",2023,150,91,10.3722544827586,59
"1396","WI-043035",1979,190,102,11.6017491954023,88
"1397","WI-043035",1980,175,91,11.964553373494,84
"1398","WI-043035",1981,182,79,11.1309410784314,103
"1399","WI-043035",1982,185,101,12.3441806024096,84
"1400","WI-043035",1983,172,108,11.0541315873016,64
"1401","WI-043035",1984,193,92,12.1676561,101
"1402","WI-043035",1985,185,92,12.523582173913,93
"1403","WI-043035",1986,186,85,12.1294793,101
"1404","WI-043035",1987,150,92,11.7511015789474,58
"1405","WI-043035",1988,150,90,9.65075203389831,60
"1406","WI-043035",1989,171,102,11.0358870588235,69
"1407","WI-043035",1990,178,99,12.2618691025641,79
"1408","WI-043035",1991,133,90,8.07348023809524,43
"1409","WI-043035",1992,NA,104,NA,NA
"1410","WI-043035",1993,208,93,12.2938876315789,115
"1411","WI-043035",1994,166,95,10.6877544285714,71
"1412","WI-043035",1995,166,100,9.61307923076923,66
"1413","WI-043035",1996,180,105,10.9384818918919,75
"1414","WI-043035",1997,174,102,10.590768028169,72
"1415","WI-043035",1998,167,81,11.3016025882353,86
"1416","WI-043035",1999,157,85,10.1479302816901,72
"1417","WI-043035",2000,192,78,11.4700684955752,114
"1418","WI-043035",2001,163,89,10.4850916438356,74
"1419","WI-043035",2002,172,96,10.3506321333333,76
"1420","WI-043035",2003,173,98,12.0552343243243,75
"1421","WI-043035",2004,193,84,11.0307606481481,109
"1422","WI-043035",2005,171,85,11.5409535294118,86
"1423","WI-043035",2006,146,86,9.11915898305085,60
"1424","WI-043035",2007,163,101,13.9601432786885,62
"1425","WI-043035",2008,191,91,11.4081688888889,100
"1426","WI-043035",2009,168,95,10.4441745833333,73
"1427","WI-043035",2010,142,67,8.44011810810811,75
"1428","WI-043035",2011,179,89,10.8782873033708,90
"1429","WI-043035",2012,170,70,11.0393486868687,100
"1430","WI-043035",2013,173,107,11.6988067692308,66
"1431","WI-043035",2014,171,107,11.9213068253968,64
"1432","WI-043035",2015,191,86,12.69525,105
"1433","WI-043035",2016,168,100,12.580008358209,68
"1434","WI-043035",2017,161,76,9.47361761904762,85
"1435","WI-043035",2018,144,109,11.7579397058824,35
"1436","WI-043035",2019,178,91,10.6042505813953,87
"1437","WI-043035",2020,171,84,9.47971313953488,87
"1438","WI-043035",2021,154,74,8.60065126582279,80
"1439","WI-043035",2022,168,108,12.4347657627119,60
"1440","WI-043035",2023,151,97,10.145589245283,54
"1441","WI-043037",1979,190,102,11.6017491954023,88
"1442","WI-043037",1980,175,91,11.964553373494,84
"1443","WI-043037",1981,182,79,11.1309410784314,103
"1444","WI-043037",1982,185,101,12.3441806024096,84
"1445","WI-043037",1983,172,108,11.0541315873016,64
"1446","WI-043037",1984,193,92,12.1676561,101
"1447","WI-043037",1985,185,92,12.523582173913,93
"1448","WI-043037",1986,186,85,12.1294793,101
"1449","WI-043037",1987,150,92,11.7511015789474,58
"1450","WI-043037",1988,150,90,9.65075203389831,60
"1451","WI-043037",1989,171,102,11.0358870588235,69
"1452","WI-043037",1990,178,99,12.2618691025641,79
"1453","WI-043037",1991,133,90,8.07348023809524,43
"1454","WI-043037",1992,NA,104,NA,NA
"1455","WI-043037",1993,208,93,12.2938876315789,115
"1456","WI-043037",1994,166,95,10.6877544285714,71
"1457","WI-043037",1995,166,100,9.61307923076923,66
"1458","WI-043037",1996,180,105,10.9384818918919,75
"1459","WI-043037",1997,174,102,10.590768028169,72
"1460","WI-043037",1998,167,81,11.3016025882353,86
"1461","WI-043037",1999,157,85,10.1479302816901,72
"1462","WI-043037",2000,192,78,11.4700684955752,114
"1463","WI-043037",2001,163,89,10.4850916438356,74
"1464","WI-043037",2002,172,96,10.3506321333333,76
"1465","WI-043037",2003,173,98,12.0552343243243,75
"1466","WI-043037",2004,193,84,11.0307606481481,109
"1467","WI-043037",2005,171,85,11.5409535294118,86
"1468","WI-043037",2006,146,86,9.11915898305085,60
"1469","WI-043037",2007,163,101,13.9601432786885,62
"1470","WI-043037",2008,191,91,11.4081688888889,100
"1471","WI-043037",2009,168,95,10.4441745833333,73
"1472","WI-043037",2010,142,67,8.44011810810811,75
"1473","WI-043037",2011,179,89,10.8782873033708,90
"1474","WI-043037",2012,170,70,11.0393486868687,100
"1475","WI-043037",2013,173,107,11.6988067692308,66
"1476","WI-043037",2014,171,107,11.9213068253968,64
"1477","WI-043037",2015,191,86,12.69525,105
"1478","WI-043037",2016,168,100,12.580008358209,68
"1479","WI-043037",2017,161,76,9.47361761904762,85
"1480","WI-043037",2018,144,109,11.7579397058824,35
"1481","WI-043037",2019,178,91,10.6042505813953,87
"1482","WI-043037",2020,171,84,9.47971313953488,87
"1483","WI-043037",2021,154,74,8.60065126582279,80
"1484","WI-043037",2022,168,108,12.4347657627119,60
"1485","WI-043037",2023,151,97,10.145589245283,54
"1486","WI-043077",1979,190,103,11.2173144186047,87
"1487","WI-043077",1980,175,102,12.7660898611111,73
"1488","WI-043077",1981,184,80,10.6009561165049,104
"1489","WI-043077",1982,195,101,12.4820937634409,94
"1490","WI-043077",1983,173,108,10.7133846875,65
"1491","WI-043077",1984,193,92,11.5862505,101
"1492","WI-043077",1985,186,92,11.8582072043011,94
"1493","WI-043077",1986,186,86,11.3546446464646,100
"1494","WI-043077",1987,165,92,12.1725713888889,73
"1495","WI-043077",1988,150,91,8.86258275862069,59
"1496","WI-043077",1989,172,102,10.3434843478261,70
"1497","WI-043077",1990,178,99,11.780598974359,79
"1498","WI-043077",1991,177,90,12.2470230232558,87
"1499","WI-043077",1992,NA,105,NA,NA
"1500","WI-043077",1993,210,95,11.8256943859649,115
"1501","WI-043077",1994,171,96,10.9492735135135,75
"1502","WI-043077",1995,166,103,9.49966661290323,63
"1503","WI-043077",1996,180,105,10.1791917567568,75
"1504","WI-043077",1997,177,102,10.2586109459459,75
"1505","WI-043077",1998,180,81,11.6562376530612,99
"1506","WI-043077",1999,175,86,10.7909780681818,89
"1507","WI-043077",2000,193,78,10.7974424561404,115
"1508","WI-043077",2001,175,88,10.749763372093,87
"1509","WI-043077",2002,173,96,9.8425925,77
"1510","WI-043077",2003,173,98,11.4297060810811,75
"1511","WI-043077",2004,193,84,10.3922331481481,109
"1512","WI-043077",2005,171,86,11.0394526190476,85
"1513","WI-043077",2006,147,86,8.981253,61
"1514","WI-043077",2007,162,101,13.3476696666667,61
"1515","WI-043077",2008,197,102,12.4740284042553,95
"1516","WI-043077",2009,171,95,10.2460654666667,76
"1517","WI-043077",2010,142,67,8.0172927027027,75
"1518","WI-043077",2011,179,90,10.1521636363636,89
"1519","WI-043077",2012,179,69,11.4978196330275,110
"1520","WI-043077",2013,174,107,11.1508678787879,67
"1521","WI-043077",2014,190,107,12.9921863414634,83
"1522","WI-043077",2015,191,86,12.2885496153846,105
"1523","WI-043077",2016,171,101,12.1579568115942,70
"1524","WI-043077",2017,162,78,9.18056012048193,84
"1525","WI-043077",2018,144,109,11.3137767647059,35
"1526","WI-043077",2019,179,91,10.0004127586207,88
"1527","WI-043077",2020,170,107,11.4366624193548,63
"1528","WI-043077",2021,154,74,8.18401797468354,80
"1529","WI-043077",2022,168,108,11.6442459322034,60
"1530","WI-043077",2023,151,98,9.56229634615385,53
"1531","WI-043113",1979,190,101,11.1707845454545,89
"1532","WI-043113",1980,175,104,13.2273198571429,71
"1533","WI-043113",1981,184,80,10.7772301941748,104
"1534","WI-043113",1982,185,100,11.8561675,85
"1535","WI-043113",1983,173,108,10.6536921875,65
"1536","WI-043113",1984,193,91,11.5878545544554,102
"1537","WI-043113",1985,186,97,12.9291029545455,89
"1538","WI-043113",1986,186,84,11.7403328712871,102
"1539","WI-043113",1987,150,93,11.6771516071429,57
"1540","WI-043113",1988,150,85,8.7123890625,65
"1541","WI-043113",1989,172,102,10.7835886956522,70
"1542","WI-043113",1990,178,99,11.8509114102564,79
"1543","WI-043113",1991,133,90,7.7282430952381,43
"1544","WI-043113",1992,NA,105,NA,NA
"1545","WI-043113",1993,222,94,12.5267058267717,128
"1546","WI-043113",1994,166,95,10.0857457142857,71
"1547","WI-043113",1995,166,100,9.28519476923077,66
"1548","WI-043113",1996,180,106,10.6062726027397,74
"1549","WI-043113",1997,173,103,9.97321115942029,70
"1550","WI-043113",1998,169,81,11.154425862069,88
"1551","WI-043113",1999,157,84,9.92036625,73
"1552","WI-043113",2000,193,78,11.155653245614,115
"1553","WI-043113",2001,163,89,9.98027602739726,74
"1554","WI-043113",2002,173,97,10.0733254666667,76
"1555","WI-043113",2003,183,98,12.4291133333333,85
"1556","WI-043113",2004,194,83,10.6892648181818,111
"1557","WI-043113",2005,160,85,10.0139594594595,75
"1558","WI-043113",2006,146,86,8.83539288135593,60
"1559","WI-043113",2007,163,101,13.3525614754098,62
"1560","WI-043113",2008,191,102,12.1673682954545,89
"1561","WI-043113",2009,169,96,10.2481777777778,73
"1562","WI-043113",2010,142,66,8.0493716,76
"1563","WI-043113",2011,179,89,10.5083786516854,90
"1564","WI-043113",2012,170,69,10.8383295,101
"1565","WI-043113",2013,173,108,11.59182390625,65
"1566","WI-043113",2014,177,106,12.519223,71
"1567","WI-043113",2015,192,87,12.3710478846154,105
"1568","WI-043113",2016,169,101,12.5124458208955,68
"1569","WI-043113",2017,161,78,9.11233195121951,83
"1570","WI-043113",2018,144,109,11.4247597058824,35
"1571","WI-043113",2019,178,92,10.1974532941176,86
"1572","WI-043113",2020,179,108,12.4700415714286,71
"1573","WI-043113",2021,155,75,8.39623455696202,80
"1574","WI-043113",2022,169,108,12.2141876666667,61
"1575","WI-043113",2023,151,97,10.0485964150943,54
"1576","WI-043126",1979,190,101,11.1707845454545,89
"1577","WI-043126",1980,175,104,13.2273198571429,71
"1578","WI-043126",1981,184,80,10.7772301941748,104
"1579","WI-043126",1982,185,100,11.8561675,85
"1580","WI-043126",1983,173,108,10.6536921875,65
"1581","WI-043126",1984,193,91,11.5878545544554,102
"1582","WI-043126",1985,186,97,12.9291029545455,89
"1583","WI-043126",1986,186,84,11.7403328712871,102
"1584","WI-043126",1987,150,93,11.6771516071429,57
"1585","WI-043126",1988,150,85,8.7123890625,65
"1586","WI-043126",1989,172,102,10.7835886956522,70
"1587","WI-043126",1990,178,99,11.8509114102564,79
"1588","WI-043126",1991,133,90,7.7282430952381,43
"1589","WI-043126",1992,NA,105,NA,NA
"1590","WI-043126",1993,222,94,12.5267058267717,128
"1591","WI-043126",1994,166,95,10.0857457142857,71
"1592","WI-043126",1995,166,100,9.28519476923077,66
"1593","WI-043126",1996,180,106,10.6062726027397,74
"1594","WI-043126",1997,173,103,9.97321115942029,70
"1595","WI-043126",1998,169,81,11.154425862069,88
"1596","WI-043126",1999,157,84,9.92036625,73
"1597","WI-043126",2000,193,78,11.155653245614,115
"1598","WI-043126",2001,163,89,9.98027602739726,74
"1599","WI-043126",2002,173,97,10.0733254666667,76
"1600","WI-043126",2003,183,98,12.4291133333333,85
"1601","WI-043126",2004,194,83,10.6892648181818,111
"1602","WI-043126",2005,160,85,10.0139594594595,75
"1603","WI-043126",2006,146,86,8.83539288135593,60
"1604","WI-043126",2007,163,101,13.3525614754098,62
"1605","WI-043126",2008,191,102,12.1673682954545,89
"1606","WI-043126",2009,169,96,10.2481777777778,73
"1607","WI-043126",2010,142,66,8.0493716,76
"1608","WI-043126",2011,179,89,10.5083786516854,90
"1609","WI-043126",2012,170,69,10.8383295,101
"1610","WI-043126",2013,173,108,11.59182390625,65
"1611","WI-043126",2014,177,106,12.519223,71
"1612","WI-043126",2015,192,87,12.3710478846154,105
"1613","WI-043126",2016,169,101,12.5124458208955,68
"1614","WI-043126",2017,161,78,9.11233195121951,83
"1615","WI-043126",2018,144,109,11.4247597058824,35
"1616","WI-043126",2019,178,92,10.1974532941176,86
"1617","WI-043126",2020,179,108,12.4700415714286,71
"1618","WI-043126",2021,155,75,8.39623455696202,80
"1619","WI-043126",2022,169,108,12.2141876666667,61
"1620","WI-043126",2023,151,97,10.0485964150943,54
"1621","WI-043129",1979,190,102,11.6017491954023,88
"1622","WI-043129",1980,175,91,11.964553373494,84
"1623","WI-043129",1981,182,79,11.1309410784314,103
"1624","WI-043129",1982,185,101,12.3441806024096,84
"1625","WI-043129",1983,172,108,11.0541315873016,64
"1626","WI-043129",1984,193,92,12.1676561,101
"1627","WI-043129",1985,185,92,12.523582173913,93
"1628","WI-043129",1986,186,85,12.1294793,101
"1629","WI-043129",1987,150,92,11.7511015789474,58
"1630","WI-043129",1988,150,90,9.65075203389831,60
"1631","WI-043129",1989,171,102,11.0358870588235,69
"1632","WI-043129",1990,178,99,12.2618691025641,79
"1633","WI-043129",1991,133,90,8.07348023809524,43
"1634","WI-043129",1992,NA,104,NA,NA
"1635","WI-043129",1993,208,93,12.2938876315789,115
"1636","WI-043129",1994,166,95,10.6877544285714,71
"1637","WI-043129",1995,166,100,9.61307923076923,66
"1638","WI-043129",1996,180,105,10.9384818918919,75
"1639","WI-043129",1997,174,102,10.590768028169,72
"1640","WI-043129",1998,167,81,11.3016025882353,86
"1641","WI-043129",1999,157,85,10.1479302816901,72
"1642","WI-043129",2000,192,78,11.4700684955752,114
"1643","WI-043129",2001,163,89,10.4850916438356,74
"1644","WI-043129",2002,172,96,10.3506321333333,76
"1645","WI-043129",2003,173,98,12.0552343243243,75
"1646","WI-043129",2004,193,84,11.0307606481481,109
"1647","WI-043129",2005,171,85,11.5409535294118,86
"1648","WI-043129",2006,146,86,9.11915898305085,60
"1649","WI-043129",2007,163,101,13.9601432786885,62
"1650","WI-043129",2008,191,91,11.4081688888889,100
"1651","WI-043129",2009,168,95,10.4441745833333,73
"1652","WI-043129",2010,142,67,8.44011810810811,75
"1653","WI-043129",2011,179,89,10.8782873033708,90
"1654","WI-043129",2012,170,70,11.0393486868687,100
"1655","WI-043129",2013,173,107,11.6988067692308,66
"1656","WI-043129",2014,171,107,11.9213068253968,64
"1657","WI-043129",2015,191,86,12.69525,105
"1658","WI-043129",2016,168,100,12.580008358209,68
"1659","WI-043129",2017,161,76,9.47361761904762,85
"1660","WI-043129",2018,144,109,11.7579397058824,35
"1661","WI-043129",2019,178,91,10.6042505813953,87
"1662","WI-043129",2020,171,84,9.47971313953488,87
"1663","WI-043129",2021,154,74,8.60065126582279,80
"1664","WI-043129",2022,168,108,12.4347657627119,60
"1665","WI-043129",2023,151,97,10.145589245283,54
"1666","WI-043148",1979,190,102,11.6017491954023,88
"1667","WI-043148",1980,175,91,11.964553373494,84
"1668","WI-043148",1981,182,79,11.1309410784314,103
"1669","WI-043148",1982,185,101,12.3441806024096,84
"1670","WI-043148",1983,172,108,11.0541315873016,64
"1671","WI-043148",1984,193,92,12.1676561,101
"1672","WI-043148",1985,185,92,12.523582173913,93
"1673","WI-043148",1986,186,85,12.1294793,101
"1674","WI-043148",1987,150,92,11.7511015789474,58
"1675","WI-043148",1988,150,90,9.65075203389831,60
"1676","WI-043148",1989,171,102,11.0358870588235,69
"1677","WI-043148",1990,178,99,12.2618691025641,79
"1678","WI-043148",1991,133,90,8.07348023809524,43
"1679","WI-043148",1992,NA,104,NA,NA
"1680","WI-043148",1993,208,93,12.2938876315789,115
"1681","WI-043148",1994,166,95,10.6877544285714,71
"1682","WI-043148",1995,166,100,9.61307923076923,66
"1683","WI-043148",1996,180,105,10.9384818918919,75
"1684","WI-043148",1997,174,102,10.590768028169,72
"1685","WI-043148",1998,167,81,11.3016025882353,86
"1686","WI-043148",1999,157,85,10.1479302816901,72
"1687","WI-043148",2000,192,78,11.4700684955752,114
"1688","WI-043148",2001,163,89,10.4850916438356,74
"1689","WI-043148",2002,172,96,10.3506321333333,76
"1690","WI-043148",2003,173,98,12.0552343243243,75
"1691","WI-043148",2004,193,84,11.0307606481481,109
"1692","WI-043148",2005,171,85,11.5409535294118,86
"1693","WI-043148",2006,146,86,9.11915898305085,60
"1694","WI-043148",2007,163,101,13.9601432786885,62
"1695","WI-043148",2008,191,91,11.4081688888889,100
"1696","WI-043148",2009,168,95,10.4441745833333,73
"1697","WI-043148",2010,142,67,8.44011810810811,75
"1698","WI-043148",2011,179,89,10.8782873033708,90
"1699","WI-043148",2012,170,70,11.0393486868687,100
"1700","WI-043148",2013,173,107,11.6988067692308,66
"1701","WI-043148",2014,171,107,11.9213068253968,64
"1702","WI-043148",2015,191,86,12.69525,105
"1703","WI-043148",2016,168,100,12.580008358209,68
"1704","WI-043148",2017,161,76,9.47361761904762,85
"1705","WI-043148",2018,144,109,11.7579397058824,35
"1706","WI-043148",2019,178,91,10.6042505813953,87
"1707","WI-043148",2020,171,84,9.47971313953488,87
"1708","WI-043148",2021,154,74,8.60065126582279,80
"1709","WI-043148",2022,168,108,12.4347657627119,60
"1710","WI-043148",2023,151,97,10.145589245283,54
"1711","WI-043156",1979,190,102,11.6017491954023,88
"1712","WI-043156",1980,175,91,11.964553373494,84
"1713","WI-043156",1981,182,79,11.1309410784314,103
"1714","WI-043156",1982,185,101,12.3441806024096,84
"1715","WI-043156",1983,172,108,11.0541315873016,64
"1716","WI-043156",1984,193,92,12.1676561,101
"1717","WI-043156",1985,185,92,12.523582173913,93
"1718","WI-043156",1986,186,85,12.1294793,101
"1719","WI-043156",1987,150,92,11.7511015789474,58
"1720","WI-043156",1988,150,90,9.65075203389831,60
"1721","WI-043156",1989,171,102,11.0358870588235,69
"1722","WI-043156",1990,178,99,12.2618691025641,79
"1723","WI-043156",1991,133,90,8.07348023809524,43
"1724","WI-043156",1992,NA,104,NA,NA
"1725","WI-043156",1993,208,93,12.2938876315789,115
"1726","WI-043156",1994,166,95,10.6877544285714,71
"1727","WI-043156",1995,166,100,9.61307923076923,66
"1728","WI-043156",1996,180,105,10.9384818918919,75
"1729","WI-043156",1997,174,102,10.590768028169,72
"1730","WI-043156",1998,167,81,11.3016025882353,86
"1731","WI-043156",1999,157,85,10.1479302816901,72
"1732","WI-043156",2000,192,78,11.4700684955752,114
"1733","WI-043156",2001,163,89,10.4850916438356,74
"1734","WI-043156",2002,172,96,10.3506321333333,76
"1735","WI-043156",2003,173,98,12.0552343243243,75
"1736","WI-043156",2004,193,84,11.0307606481481,109
"1737","WI-043156",2005,171,85,11.5409535294118,86
"1738","WI-043156",2006,146,86,9.11915898305085,60
"1739","WI-043156",2007,163,101,13.9601432786885,62
"1740","WI-043156",2008,191,91,11.4081688888889,100
"1741","WI-043156",2009,168,95,10.4441745833333,73
"1742","WI-043156",2010,142,67,8.44011810810811,75
"1743","WI-043156",2011,179,89,10.8782873033708,90
"1744","WI-043156",2012,170,70,11.0393486868687,100
"1745","WI-043156",2013,173,107,11.6988067692308,66
"1746","WI-043156",2014,171,107,11.9213068253968,64
"1747","WI-043156",2015,191,86,12.69525,105
"1748","WI-043156",2016,168,100,12.580008358209,68
"1749","WI-043156",2017,161,76,9.47361761904762,85
"1750","WI-043156",2018,144,109,11.7579397058824,35
"1751","WI-043156",2019,178,91,10.6042505813953,87
"1752","WI-043156",2020,171,84,9.47971313953488,87
"1753","WI-043156",2021,154,74,8.60065126582279,80
"1754","WI-043156",2022,168,108,12.4347657627119,60
"1755","WI-043156",2023,151,97,10.145589245283,54
"1756","WI-043157",1979,190,102,11.6017491954023,88
"1757","WI-043157",1980,175,91,11.964553373494,84
"1758","WI-043157",1981,182,79,11.1309410784314,103
"1759","WI-043157",1982,185,101,12.3441806024096,84
"1760","WI-043157",1983,172,108,11.0541315873016,64
"1761","WI-043157",1984,193,92,12.1676561,101
"1762","WI-043157",1985,185,92,12.523582173913,93
"1763","WI-043157",1986,186,85,12.1294793,101
"1764","WI-043157",1987,150,92,11.7511015789474,58
"1765","WI-043157",1988,150,90,9.65075203389831,60
"1766","WI-043157",1989,171,102,11.0358870588235,69
"1767","WI-043157",1990,178,99,12.2618691025641,79
"1768","WI-043157",1991,133,90,8.07348023809524,43
"1769","WI-043157",1992,NA,104,NA,NA
"1770","WI-043157",1993,208,93,12.2938876315789,115
"1771","WI-043157",1994,166,95,10.6877544285714,71
"1772","WI-043157",1995,166,100,9.61307923076923,66
"1773","WI-043157",1996,180,105,10.9384818918919,75
"1774","WI-043157",1997,174,102,10.590768028169,72
"1775","WI-043157",1998,167,81,11.3016025882353,86
"1776","WI-043157",1999,157,85,10.1479302816901,72
"1777","WI-043157",2000,192,78,11.4700684955752,114
"1778","WI-043157",2001,163,89,10.4850916438356,74
"1779","WI-043157",2002,172,96,10.3506321333333,76
"1780","WI-043157",2003,173,98,12.0552343243243,75
"1781","WI-043157",2004,193,84,11.0307606481481,109
"1782","WI-043157",2005,171,85,11.5409535294118,86
"1783","WI-043157",2006,146,86,9.11915898305085,60
"1784","WI-043157",2007,163,101,13.9601432786885,62
"1785","WI-043157",2008,191,91,11.4081688888889,100
"1786","WI-043157",2009,168,95,10.4441745833333,73
"1787","WI-043157",2010,142,67,8.44011810810811,75
"1788","WI-043157",2011,179,89,10.8782873033708,90
"1789","WI-043157",2012,170,70,11.0393486868687,100
"1790","WI-043157",2013,173,107,11.6988067692308,66
"1791","WI-043157",2014,171,107,11.9213068253968,64
"1792","WI-043157",2015,191,86,12.69525,105
"1793","WI-043157",2016,168,100,12.580008358209,68
"1794","WI-043157",2017,161,76,9.47361761904762,85
"1795","WI-043157",2018,144,109,11.7579397058824,35
"1796","WI-043157",2019,178,91,10.6042505813953,87
"1797","WI-043157",2020,171,84,9.47971313953488,87
"1798","WI-043157",2021,154,74,8.60065126582279,80
"1799","WI-043157",2022,168,108,12.4347657627119,60
"1800","WI-043157",2023,151,97,10.145589245283,54
"1801","WI-043161",1979,190,102,11.6017491954023,88
"1802","WI-043161",1980,175,91,11.964553373494,84
"1803","WI-043161",1981,182,79,11.1309410784314,103
"1804","WI-043161",1982,185,101,12.3441806024096,84
"1805","WI-043161",1983,172,108,11.0541315873016,64
"1806","WI-043161",1984,193,92,12.1676561,101
"1807","WI-043161",1985,185,92,12.523582173913,93
"1808","WI-043161",1986,186,85,12.1294793,101
"1809","WI-043161",1987,150,92,11.7511015789474,58
"1810","WI-043161",1988,150,90,9.65075203389831,60
"1811","WI-043161",1989,171,102,11.0358870588235,69
"1812","WI-043161",1990,178,99,12.2618691025641,79
"1813","WI-043161",1991,133,90,8.07348023809524,43
"1814","WI-043161",1992,NA,104,NA,NA
"1815","WI-043161",1993,208,93,12.2938876315789,115
"1816","WI-043161",1994,166,95,10.6877544285714,71
"1817","WI-043161",1995,166,100,9.61307923076923,66
"1818","WI-043161",1996,180,105,10.9384818918919,75
"1819","WI-043161",1997,174,102,10.590768028169,72
"1820","WI-043161",1998,167,81,11.3016025882353,86
"1821","WI-043161",1999,157,85,10.1479302816901,72
"1822","WI-043161",2000,192,78,11.4700684955752,114
"1823","WI-043161",2001,163,89,10.4850916438356,74
"1824","WI-043161",2002,172,96,10.3506321333333,76
"1825","WI-043161",2003,173,98,12.0552343243243,75
"1826","WI-043161",2004,193,84,11.0307606481481,109
"1827","WI-043161",2005,171,85,11.5409535294118,86
"1828","WI-043161",2006,146,86,9.11915898305085,60
"1829","WI-043161",2007,163,101,13.9601432786885,62
"1830","WI-043161",2008,191,91,11.4081688888889,100
"1831","WI-043161",2009,168,95,10.4441745833333,73
"1832","WI-043161",2010,142,67,8.44011810810811,75
"1833","WI-043161",2011,179,89,10.8782873033708,90
"1834","WI-043161",2012,170,70,11.0393486868687,100
"1835","WI-043161",2013,173,107,11.6988067692308,66
"1836","WI-043161",2014,171,107,11.9213068253968,64
"1837","WI-043161",2015,191,86,12.69525,105
"1838","WI-043161",2016,168,100,12.580008358209,68
"1839","WI-043161",2017,161,76,9.47361761904762,85
"1840","WI-043161",2018,144,109,11.7579397058824,35
"1841","WI-043161",2019,178,91,10.6042505813953,87
"1842","WI-043161",2020,171,84,9.47971313953488,87
"1843","WI-043161",2021,154,74,8.60065126582279,80
"1844","WI-043161",2022,168,108,12.4347657627119,60
"1845","WI-043161",2023,151,97,10.145589245283,54
"1846","WI-073099",1979,190,102,11.8411526436782,88
"1847","WI-073099",1980,147,92,10.0647848148148,55
"1848","WI-073099",1981,182,79,11.325487745098,103
"1849","WI-073099",1982,184,101,12.5053645121951,83
"1850","WI-073099",1983,172,108,11.1299007936508,64
"1851","WI-073099",1984,193,92,12.2597658,101
"1852","WI-073099",1985,185,91,12.713,94
"1853","WI-073099",1986,170,85,11.0651883333333,85
"1854","WI-073099",1987,149,92,11.8781596428571,57
"1855","WI-073099",1988,150,90,9.70795525423729,60
"1856","WI-073099",1989,171,102,11.2322327941176,69
"1857","WI-073099",1990,177,99,12.2718831168831,78
"1858","WI-073099",1991,133,90,8.15365095238095,43
"1859","WI-073099",1992,NA,91,NA,NA
"1860","WI-073099",1993,206,93,12.4009567857143,113
"1861","WI-073099",1994,166,93,10.5780859722222,73
"1862","WI-073099",1995,166,98,9.61414925373134,68
"1863","WI-073099",1996,165,103,9.26866360655738,62
"1864","WI-073099",1997,173,102,10.64932,71
"1865","WI-073099",1998,167,81,11.4190661176471,86
"1866","WI-073099",1999,157,84,10.2137691666667,73
"1867","WI-073099",2000,189,77,11.3499289189189,112
"1868","WI-073099",2001,162,89,10.44699625,73
"1869","WI-073099",2002,160,96,9.15331317460318,64
"1870","WI-073099",2003,167,98,11.5857289705882,69
"1871","WI-073099",2004,193,83,11.1080467889908,110
"1872","WI-073099",2005,159,85,10.4409815068493,74
"1873","WI-073099",2006,146,85,9.0641425,61
"1874","WI-073099",2007,162,101,13.8424615,61
"1875","WI-073099",2008,190,91,11.4089417346939,99
"1876","WI-073099",2009,168,96,10.6942667605634,72
"1877","WI-073099",2010,142,67,8.41594162162162,75
"1878","WI-073099",2011,179,89,11.0451587640449,90
"1879","WI-073099",2012,160,69,10.3704245555556,91
"1880","WI-073099",2013,173,107,11.8040952307692,66
"1881","WI-073099",2014,170,106,11.8650603174603,64
"1882","WI-073099",2015,178,86,11.9143404395604,92
"1883","WI-073099",2016,164,100,12.3445742857143,64
"1884","WI-073099",2017,160,77,9.62802768292683,83
"1885","WI-073099",2018,144,108,11.6913654285714,36
"1886","WI-073099",2019,177,82,9.77970010638298,95
"1887","WI-073099",2020,171,104,11.5499392424242,67
"1888","WI-073099",2021,142,74,7.49779104477612,68
"1889","WI-073099",2022,168,107,12.4083853333333,61
"1890","WI-073099",2023,151,97,10.4417266037736,54
"1891","WI-073100",1979,190,99,12.1404636666667,91
"1892","WI-073100",1980,144,87,9.15972517857143,57
"1893","WI-073100",1981,181,79,11.6924132673267,102
"1894","WI-073100",1982,184,100,12.8627856626506,84
"1895","WI-073100",1983,172,108,11.4040820634921,64
"1896","WI-073100",1984,172,89,10.6307726829268,83
"1897","WI-073100",1985,185,77,11.7889180373832,108
"1898","WI-073100",1986,169,83,11.4433541176471,86
"1899","WI-073100",1987,149,92,12.5077635714286,57
"1900","WI-073100",1988,150,84,9.516482,66
"1901","WI-073100",1989,171,101,11.687245942029,70
"1902","WI-073100",1990,176,95,11.95667925,81
"1903","WI-073100",1991,133,75,6.97400333333333,58
"1904","WI-073100",1992,166,90,10.3398949333333,76
"1905","WI-073100",1993,206,83,11.9445082786885,123
"1906","WI-073100",1994,165,88,10.1689061842105,77
"1907","WI-073100",1995,166,98,10.0574795522388,68
"1908","WI-073100",1996,165,102,9.50185161290323,63
"1909","WI-073100",1997,172,101,10.7244172857143,71
"1910","WI-073100",1998,166,81,11.8039983333333,85
"1911","WI-073100",1999,157,81,10.5368646666667,76
"1912","WI-073100",2000,185,77,11.5385493457944,108
"1913","WI-073100",2001,162,89,10.7865144444444,73
"1914","WI-073100",2002,160,96,9.60606666666667,64
"1915","WI-073100",2003,166,98,11.8100753731343,68
"1916","WI-073100",2004,193,82,11.5482504545455,111
"1917","WI-073100",2005,156,85,10.3610078571429,71
"1918","WI-073100",2006,146,85,9.30724166666667,61
"1919","WI-073100",2007,163,101,14.2919818032787,62
"1920","WI-073100",2008,187,91,11.4967318947368,96
"1921","WI-073100",2009,167,95,10.95333,72
"1922","WI-073100",2010,142,66,8.52208013333333,76
"1923","WI-073100",2011,156,89,9.39938484848485,67
"1924","WI-073100",2012,159,68,10.7675588888889,91
"1925","WI-073100",2013,172,107,11.92366859375,65
"1926","WI-073100",2014,149,95,8.42157924528302,54
"1927","WI-073100",2015,175,86,11.9267098863636,89
"1928","WI-073100",2016,164,98,12.3789590769231,66
"1929","WI-073100",2017,159,77,9.87574617283951,82
"1930","WI-073100",2018,144,109,12.1400632352941,35
"1931","WI-073100",2019,177,83,10.2573705376344,94
"1932","WI-073100",2020,157,107,11.0180471428571,50
"1933","WI-073100",2021,141,68,7.12668208333333,73
"1934","WI-073100",2022,167,107,12.7131474576271,60
"1935","WI-073100",2023,151,91,10.2196293220339,60
"1936","WI-083044",1979,190,101,12.4296622727273,89
"1937","WI-083044",1980,175,88,11.420843372093,87
"1938","WI-083044",1981,164,84,8.82959430379747,80
"1939","WI-083044",1982,185,102,13.1046686585366,83
"1940","WI-083044",1983,163,110,9.64631980769231,53
"1941","WI-083044",1984,157,92,9.0834459375,65
"1942","WI-083044",1985,184,82,12.3970771287129,102
"1943","WI-083044",1986,176,83,12.1814779347826,93
"1944","WI-083044",1987,148,92,11.0341192727273,56
"1945","WI-083044",1988,150,81,8.84027485294118,69
"1946","WI-083044",1989,172,82,10.4153250561798,90
"1947","WI-083044",1990,165,85,10.0968921518987,80
"1948","WI-083044",1991,133,74,7.63306879310345,59
"1949","WI-083044",1992,220,84,12.6069546666667,136
"1950","WI-083044",1993,185,81,10.5618095145631,104
"1951","WI-083044",1994,164,78,9.09030635294118,86
"1952","WI-083044",1995,166,97,10.3484132352941,69
"1953","WI-083044",1996,179,99,10.659036835443,80
"1954","WI-083044",1997,172,101,10.3721851428571,71
"1955","WI-083044",1998,136,81,9.63568907407407,55
"1956","WI-083044",1999,157,74,9.94919256097561,83
"1957","WI-083044",2000,174,52,9.85235603305785,122
"1958","WI-083044",2001,162,87,10.976792972973,75
"1959","WI-083044",2002,171,94,10.9284298684211,77
"1960","WI-083044",2003,174,98,11.9895529333333,76
"1961","WI-083044",2004,194,80,12.2583504424779,114
"1962","WI-083044",2005,155,82,9.9787325,73
"1963","WI-083044",2006,147,83,9.74973968253968,64
"1964","WI-083044",2007,151,100,12.5123466,51
"1965","WI-083044",2008,159,87,9.76316070422535,72
"1966","WI-083044",2009,170,73,9.33182708333333,97
"1967","WI-083044",2010,144,66,8.78413688311688,78
"1968","WI-083044",2011,156,88,9.67507671641791,68
"1969","WI-083044",2012,168,63,11.6342460576923,105
"1970","WI-083044",2013,173,85,10.4178489655172,88
"1971","WI-083044",2014,177,87,11.7852061797753,90
"1972","WI-083044",2015,174,86,12.1831079310345,88
"1973","WI-083044",2016,146,97,9.43763208333333,49
"1974","WI-083044",2017,161,77,10.3289680722892,84
"1975","WI-083044",2018,145,108,12.0182444444444,37
"1976","WI-083044",2019,176,73,9.54722941176471,103
"1977","WI-083044",2020,146,68,5.86231285714286,78
"1978","WI-083044",2021,140,66,7.81234904109589,74
"1979","WI-083044",2022,132,90,7.06192048780488,42
"1980","WI-083044",2023,150,77,8.94175652777778,73
"1981","WI-093053",1979,189,99,12.166208988764,90
"1982","WI-093053",1980,146,87,9.27491465517241,59
"1983","WI-093053",1981,181,79,11.7881744554455,102
"1984","WI-093053",1982,184,101,13.1707606097561,83
"1985","WI-093053",1983,163,107,10.1695203636364,56
"1986","WI-093053",1984,172,84,10.2409803448276,88
"1987","WI-093053",1985,180,74,11.4657796190476,106
"1988","WI-093053",1986,149,83,10.2607033846154,66
"1989","WI-093053",1987,149,92,12.3960167857143,57
"1990","WI-093053",1988,150,84,9.62405430769231,66
"1991","WI-093053",1989,171,100,11.8373444285714,71
"1992","WI-093053",1990,165,86,10.3090796153846,79
"1993","WI-093053",1991,133,75,7.32159087719298,58
"1994","WI-093053",1992,164,90,10.1703291780822,74
"1995","WI-093053",1993,186,94,11.6861878021978,92
"1996","WI-093053",1994,164,87,10.0003897368421,77
"1997","WI-093053",1995,166,98,10.2693491044776,68
"1998","WI-093053",1996,165,103,9.80631704918033,62
"1999","WI-093053",1997,171,101,10.6087557971015,70
"2000","WI-093053",1998,166,81,11.9868482142857,85
"2001","WI-093053",1999,157,75,10.0932565432099,82
"2002","WI-093053",2000,185,77,11.658803364486,108
"2003","WI-093053",2001,162,88,10.609124109589,74
"2004","WI-093053",2002,160,96,9.71097761904762,64
"2005","WI-093053",2003,166,98,11.986731641791,68
"2006","WI-093053",2004,193,82,11.9665033636364,111
"2007","WI-093053",2005,155,85,10.3209392753623,70
"2008","WI-093053",2006,146,85,9.29161633333333,61
"2009","WI-093053",2007,152,101,13.519629,51
"2010","WI-093053",2008,187,91,11.8455803157895,96
"2011","WI-093053",2009,168,90,10.5221318181818,78
"2012","WI-093053",2010,142,66,8.8752052,76
"2013","WI-093053",2011,156,89,9.67684636363636,67
"2014","WI-093053",2012,159,68,11.4620901111111,91
"2015","WI-093053",2013,172,95,10.6821677631579,77
"2016","WI-093053",2014,149,95,8.84271754716981,54
"2017","WI-093053",2015,175,86,12.1242418181818,89
"2018","WI-093053",2016,164,98,12.6415787692308,66
"2019","WI-093053",2017,158,77,9.841616875,81
"2020","WI-093053",2018,144,109,12.2489785294118,35
"2021","WI-093053",2019,177,87,10.8304480898876,90
"2022","WI-093053",2020,146,107,8.74935973684211,39
"2023","WI-093053",2021,141,67,7.46669616438356,74
"2024","WI-093053",2022,167,90,10.6530911842105,77
"2025","WI-093053",2023,151,91,10.5276272881356,60
"2026","WI-093070",1979,189,99,12.166208988764,90
"2027","WI-093070",1980,146,87,9.27491465517241,59
"2028","WI-093070",1981,181,79,11.7881744554455,102
"2029","WI-093070",1982,184,101,13.1707606097561,83
"2030","WI-093070",1983,163,107,10.1695203636364,56
"2031","WI-093070",1984,172,84,10.2409803448276,88
"2032","WI-093070",1985,180,74,11.4657796190476,106
"2033","WI-093070",1986,149,83,10.2607033846154,66
"2034","WI-093070",1987,149,92,12.3960167857143,57
"2035","WI-093070",1988,150,84,9.62405430769231,66
"2036","WI-093070",1989,171,100,11.8373444285714,71
"2037","WI-093070",1990,165,86,10.3090796153846,79
"2038","WI-093070",1991,133,75,7.32159087719298,58
"2039","WI-093070",1992,164,90,10.1703291780822,74
"2040","WI-093070",1993,186,94,11.6861878021978,92
"2041","WI-093070",1994,164,87,10.0003897368421,77
"2042","WI-093070",1995,166,98,10.2693491044776,68
"2043","WI-093070",1996,165,103,9.80631704918033,62
"2044","WI-093070",1997,171,101,10.6087557971015,70
"2045","WI-093070",1998,166,81,11.9868482142857,85
"2046","WI-093070",1999,157,75,10.0932565432099,82
"2047","WI-093070",2000,185,77,11.658803364486,108
"2048","WI-093070",2001,162,88,10.609124109589,74
"2049","WI-093070",2002,160,96,9.71097761904762,64
"2050","WI-093070",2003,166,98,11.986731641791,68
"2051","WI-093070",2004,193,82,11.9665033636364,111
"2052","WI-093070",2005,155,85,10.3209392753623,70
"2053","WI-093070",2006,146,85,9.29161633333333,61
"2054","WI-093070",2007,152,101,13.519629,51
"2055","WI-093070",2008,187,91,11.8455803157895,96
"2056","WI-093070",2009,168,90,10.5221318181818,78
"2057","WI-093070",2010,142,66,8.8752052,76
"2058","WI-093070",2011,156,89,9.67684636363636,67
"2059","WI-093070",2012,159,68,11.4620901111111,91
"2060","WI-093070",2013,172,95,10.6821677631579,77
"2061","WI-093070",2014,149,95,8.84271754716981,54
"2062","WI-093070",2015,175,86,12.1242418181818,89
"2063","WI-093070",2016,164,98,12.6415787692308,66
"2064","WI-093070",2017,158,77,9.841616875,81
"2065","WI-093070",2018,144,109,12.2489785294118,35
"2066","WI-093070",2019,177,87,10.8304480898876,90
"2067","WI-093070",2020,146,107,8.74935973684211,39
"2068","WI-093070",2021,141,67,7.46669616438356,74
"2069","WI-093070",2022,167,90,10.6530911842105,77
"2070","WI-093070",2023,151,91,10.5276272881356,60
"2071","WI-093115",1979,188,99,13.3499017045455,89
"2072","WI-093115",1980,146,85,9.73849616666667,61
"2073","WI-093115",1981,162,68,9.93009365591398,94
"2074","WI-093115",1982,183,100,13.6926864634146,83
"2075","WI-093115",1983,162,86,8.31342106666667,76
"2076","WI-093115",1984,157,82,8.98013797297297,75
"2077","WI-093115",1985,175,70,11.5895504807692,105
"2078","WI-093115",1986,148,83,10.9888184375,65
"2079","WI-093115",1987,149,92,13.0014857142857,57
"2080","WI-093115",1988,150,82,9.95242492537313,68
"2081","WI-093115",1989,170,83,10.7996977906977,87
"2082","WI-093115",1990,162,85,10.4340751315789,77
"2083","WI-093115",1991,133,74,7.87727637931035,59
"2084","WI-093115",1992,163,85,10.0342161038961,78
"2085","WI-093115",1993,185,94,12.3778233333333,91
"2086","WI-093115",1994,164,72,9.35429120879121,92
"2087","WI-093115",1995,155,97,9.8705498245614,58
"2088","WI-093115",1996,164,100,10.2039050793651,64
"2089","WI-093115",1997,170,101,11.4017886764706,69
"2090","WI-093115",1998,165,80,12.4931804761905,85
"2091","WI-093115",1999,156,74,10.4405959259259,82
"2092","WI-093115",2000,162,73,10.4387327272727,89
"2093","WI-093115",2001,161,88,11.2804981944444,73
"2094","WI-093115",2002,160,94,10.2605833846154,66
"2095","WI-093115",2003,165,98,12.5417206060606,67
"2096","WI-093115",2004,162,81,11.093753875,81
"2097","WI-093115",2005,155,85,10.9195579710145,70
"2098","WI-093115",2006,146,85,9.80724166666667,61
"2099","WI-093115",2007,151,101,14.0675916326531,50
"2100","WI-093115",2008,175,87,11.2223203448276,88
"2101","WI-093115",2009,167,74,9.8675847826087,93
"2102","WI-093115",2010,142,66,9.49332946666667,76
"2103","WI-093115",2011,154,89,10.064794375,65
"2104","WI-093115",2012,158,68,12.3951752808989,90
"2105","WI-093115",2013,164,94,10.4875531884058,70
"2106","WI-093115",2014,148,88,8.43627118644068,60
"2107","WI-093115",2015,158,86,11.2787656338028,72
"2108","WI-093115",2016,146,65,8.239028125,81
"2109","WI-093115",2017,156,76,10.321969113924,80
"2110","WI-093115",2018,144,108,12.484892,36
"2111","WI-093115",2019,157,82,9.25993121621622,75
"2112","WI-093115",2020,146,107,9.61264,39
"2113","WI-093115",2021,140,66,8.12345739726027,74
"2114","WI-093115",2022,131,89,6.5242043902439,42
"2115","WI-093115",2023,151,89,10.8547747540984,62
"2116","WI-093123",1979,189,99,12.166208988764,90
"2117","WI-093123",1980,146,87,9.27491465517241,59
"2118","WI-093123",1981,181,79,11.7881744554455,102
"2119","WI-093123",1982,184,101,13.1707606097561,83
"2120","WI-093123",1983,163,107,10.1695203636364,56
"2121","WI-093123",1984,172,84,10.2409803448276,88
"2122","WI-093123",1985,180,74,11.4657796190476,106
"2123","WI-093123",1986,149,83,10.2607033846154,66
"2124","WI-093123",1987,149,92,12.3960167857143,57
"2125","WI-093123",1988,150,84,9.62405430769231,66
"2126","WI-093123",1989,171,100,11.8373444285714,71
"2127","WI-093123",1990,165,86,10.3090796153846,79
"2128","WI-093123",1991,133,75,7.32159087719298,58
"2129","WI-093123",1992,164,90,10.1703291780822,74
"2130","WI-093123",1993,186,94,11.6861878021978,92
"2131","WI-093123",1994,164,87,10.0003897368421,77
"2132","WI-093123",1995,166,98,10.2693491044776,68
"2133","WI-093123",1996,165,103,9.80631704918033,62
"2134","WI-093123",1997,171,101,10.6087557971015,70
"2135","WI-093123",1998,166,81,11.9868482142857,85
"2136","WI-093123",1999,157,75,10.0932565432099,82
"2137","WI-093123",2000,185,77,11.658803364486,108
"2138","WI-093123",2001,162,88,10.609124109589,74
"2139","WI-093123",2002,160,96,9.71097761904762,64
"2140","WI-093123",2003,166,98,11.986731641791,68
"2141","WI-093123",2004,193,82,11.9665033636364,111
"2142","WI-093123",2005,155,85,10.3209392753623,70
"2143","WI-093123",2006,146,85,9.29161633333333,61
"2144","WI-093123",2007,152,101,13.519629,51
"2145","WI-093123",2008,187,91,11.8455803157895,96
"2146","WI-093123",2009,168,90,10.5221318181818,78
"2147","WI-093123",2010,142,66,8.8752052,76
"2148","WI-093123",2011,156,89,9.67684636363636,67
"2149","WI-093123",2012,159,68,11.4620901111111,91
"2150","WI-093123",2013,172,95,10.6821677631579,77
"2151","WI-093123",2014,149,95,8.84271754716981,54
"2152","WI-093123",2015,175,86,12.1242418181818,89
"2153","WI-093123",2016,164,98,12.6415787692308,66
"2154","WI-093123",2017,158,77,9.841616875,81
"2155","WI-093123",2018,144,109,12.2489785294118,35
"2156","WI-093123",2019,177,87,10.8304480898876,90
"2157","WI-093123",2020,146,107,8.74935973684211,39
"2158","WI-093123",2021,141,67,7.46669616438356,74
"2159","WI-093123",2022,167,90,10.6530911842105,77
"2160","WI-093123",2023,151,91,10.5276272881356,60
"2161","WI-10028991",1979,190,101,11.2301770454545,89
"2162","WI-10028991",1980,147,104,11.2085071428571,43
"2163","WI-10028991",1981,184,80,10.7868638834951,104
"2164","WI-10028991",1982,185,101,12.0813803614458,84
"2165","WI-10028991",1983,173,109,10.7809746031746,64
"2166","WI-10028991",1984,193,92,11.6210157,101
"2167","WI-10028991",1985,186,98,13.332951954023,88
"2168","WI-10028991",1986,186,84,11.8429787128713,102
"2169","WI-10028991",1987,150,93,11.6697575,57
"2170","WI-10028991",1988,150,85,8.67491359375,65
"2171","WI-10028991",1989,172,102,10.9484439130435,70
"2172","WI-10028991",1990,178,99,11.9022934615385,79
"2173","WI-10028991",1991,133,90,7.64063071428571,43
"2174","WI-10028991",1992,NA,105,NA,NA
"2175","WI-10028991",1993,222,94,12.6175025984252,128
"2176","WI-10028991",1994,165,95,9.96148304347826,70
"2177","WI-10028991",1995,166,99,9.21733393939394,67
"2178","WI-10028991",1996,180,106,10.6124793150685,74
"2179","WI-10028991",1997,173,103,9.99834695652174,70
"2180","WI-10028991",1998,168,81,11.1105808139535,87
"2181","WI-10028991",1999,157,85,10.1895235211268,72
"2182","WI-10028991",2000,193,78,11.2036242982456,115
"2183","WI-10028991",2001,163,89,9.92558849315068,74
"2184","WI-10028991",2002,173,97,10.1610333333333,76
"2185","WI-10028991",2003,183,98,12.4193477380952,85
"2186","WI-10028991",2004,194,83,10.7875606363636,111
"2187","WI-10028991",2005,158,85,9.73625722222222,73
"2188","WI-10028991",2006,146,86,8.71383593220339,60
"2189","WI-10028991",2007,163,101,13.2702098360656,62
"2190","WI-10028991",2008,190,102,12.1568505747126,88
"2191","WI-10028991",2009,169,98,10.5756737142857,71
"2192","WI-10028991",2010,142,66,7.92530893333333,76
"2193","WI-10028991",2011,179,89,10.5669284269663,90
"2194","WI-10028991",2012,169,68,10.6373575,101
"2195","WI-10028991",2013,173,108,11.74160375,65
"2196","WI-10028991",2014,170,106,11.9224749206349,64
"2197","WI-10028991",2015,192,87,12.3222192307692,105
"2198","WI-10028991",2016,169,101,12.5929037313433,68
"2199","WI-10028991",2017,161,79,9.18442111111111,82
"2200","WI-10028991",2018,145,109,11.5824357142857,36
"2201","WI-10028991",2019,178,102,11.2607304,76
"2202","WI-10028991",2020,179,109,12.5577868115942,70
"2203","WI-10028991",2021,142,76,7.29328815384615,66
"2204","WI-10028991",2022,168,108,12.2234303389831,60
"2205","WI-10028991",2023,151,97,10.1545803773585,54
"2206","WI-10043373",1979,190,102,11.8768025287356,88
"2207","WI-10043373",1980,175,92,11.3789670731707,83
"2208","WI-10043373",1981,183,82,10.8340489,101
"2209","WI-10043373",1982,186,102,12.684596626506,84
"2210","WI-10043373",1983,173,109,10.92346,64
"2211","WI-10043373",1984,193,95,11.2945702061856,98
"2212","WI-10043373",1985,192,93,13.2669916326531,99
"2213","WI-10043373",1986,186,85,12.0310419,101
"2214","WI-10043373",1987,149,93,11.5269072727273,56
"2215","WI-10043373",1988,150,84,8.86792415384615,66
"2216","WI-10043373",1989,172,101,11.1934205714286,71
"2217","WI-10043373",1990,179,86,10.9155718478261,93
"2218","WI-10043373",1991,133,74,6.5979124137931,59
"2219","WI-10043373",1992,NA,105,NA,NA
"2220","WI-10043373",1993,186,82,9.79993495145631,104
"2221","WI-10043373",1994,165,87,9.30751883116883,78
"2222","WI-10043373",1995,167,98,9.7256675,69
"2223","WI-10043373",1996,180,105,10.4979198648649,75
"2224","WI-10043373",1997,173,102,9.94898542857143,71
"2225","WI-10043373",1998,137,82,9.94222759259259,55
"2226","WI-10043373",1999,157,84,10.5377706944444,73
"2227","WI-10043373",2000,193,77,11.7791899130435,116
"2228","WI-10043373",2001,162,88,10.340181369863,74
"2229","WI-10043373",2002,173,97,10.5726990666667,76
"2230","WI-10043373",2003,174,97,11.5774338157895,77
"2231","WI-10043373",2004,194,82,11.1268833333333,112
"2232","WI-10043373",2005,156,84,9.75720957746479,72
"2233","WI-10043373",2006,147,85,9.34563901639344,62
"2234","WI-10043373",2007,152,100,12.6067249019608,52
"2235","WI-10043373",2008,190,90,12.0286038383838,100
"2236","WI-10043373",2009,170,89,10.013758625,81
"2237","WI-10043373",2010,142,64,8.31543805194805,78
"2238","WI-10043373",2011,157,89,9.06624462686567,68
"2239","WI-10043373",2012,169,68,11.0397795,101
"2240","WI-10043373",2013,173,94,10.8114688461538,79
"2241","WI-10043373",2014,177,88,11.1117361363636,89
"2242","WI-10043373",2015,192,87,12.628785,105
"2243","WI-10043373",2016,147,101,10.2144877777778,46
"2244","WI-10043373",2017,160,76,9.29547771084337,84
"2245","WI-10043373",2018,145,108,11.8481066666667,37
"2246","WI-10043373",2019,177,91,10.3693332941176,86
"2247","WI-10043373",2020,171,84,9.10216965116279,87
"2248","WI-10043373",2021,142,75,8.10452757575758,67
"2249","WI-10043373",2022,168,107,12.6310411666667,61
"2250","WI-10043373",2023,150,90,10.0646028813559,60
"2251","WI-133122",1979,157,87,10.5485686956522,70
"2252","WI-133122",1980,148,76,9.31758901408451,72
"2253","WI-133122",1981,155,78,11.2541928947368,77
"2254","WI-133122",1982,133,100,11.1566421875,33
"2255","WI-133122",1983,161,88,9.13416208333333,73
"2256","WI-133122",1984,156,84,9.3283523943662,72
"2257","WI-133122",1985,174,66,11.8538578504673,108
"2258","WI-133122",1986,149,80,10.7093666176471,69
"2259","WI-133122",1987,148,92,12.6909365454545,56
"2260","WI-133122",1988,150,79,9.89124214285714,71
"2261","WI-133122",1989,152,81,10.5433304285714,71
"2262","WI-133122",1990,162,81,10.308017,81
"2263","WI-133122",1991,132,74,9.0231498245614,58
"2264","WI-133122",1992,163,82,10.36526775,81
"2265","WI-133122",1993,162,94,11.598357761194,68
"2266","WI-133122",1994,163,70,9.80200489130435,93
"2267","WI-133122",1995,155,68,8.55366976744186,87
"2268","WI-133122",1996,165,98,10.7221618181818,67
"2269","WI-133122",1997,169,101,11.504011641791,68
"2270","WI-133122",1998,135,81,10.8916803773585,54
"2271","WI-133122",1999,155,74,10.905382625,81
"2272","WI-133122",2000,161,51,10.280078440367,110
"2273","WI-133122",2001,138,87,12.0862944,51
"2274","WI-133122",2002,150,86,9.53982238095238,64
"2275","WI-133122",2003,164,97,12.5608527272727,67
"2276","WI-133122",2004,158,75,11.575622195122,83
"2277","WI-133122",2005,155,80,11.0863704054054,75
"2278","WI-133122",2006,146,83,10.5409243548387,63
"2279","WI-133122",2007,149,100,13.7263085416667,49
"2280","WI-133122",2008,155,74,9.007567125,81
"2281","WI-133122",2009,168,72,10.5123202105263,96
"2282","WI-133122",2010,142,66,9.87291293333333,76
"2283","WI-133122",2011,152,88,10.8247663492063,64
"2284","WI-133122",2012,147,63,12.1392780722892,84
"2285","WI-133122",2013,163,85,10.9361250649351,78
"2286","WI-133122",2014,148,86,10.4802237704918,62
"2287","WI-133122",2015,158,86,12.3072645070423,72
"2288","WI-133122",2016,145,64,8.901547375,81
"2289","WI-133122",2017,160,76,11.7816406024096,84
"2290","WI-133122",2018,144,107,13.0236358333333,37
"2291","WI-133122",2019,175,70,11.2041947115385,105
"2292","WI-133122",2020,145,65,7.3280417721519,80
"2293","WI-133122",2021,140,66,9.01911191780822,74
"2294","WI-133122",2022,130,88,7.55742634146341,42
"2295","WI-133122",2023,150,76,9.84581616438356,74
"2296","WI-133125",1979,157,87,10.5485686956522,70
"2297","WI-133125",1980,148,76,9.31758901408451,72
"2298","WI-133125",1981,155,78,11.2541928947368,77
"2299","WI-133125",1982,133,100,11.1566421875,33
"2300","WI-133125",1983,161,88,9.13416208333333,73
"2301","WI-133125",1984,156,84,9.3283523943662,72
"2302","WI-133125",1985,174,66,11.8538578504673,108
"2303","WI-133125",1986,149,80,10.7093666176471,69
"2304","WI-133125",1987,148,92,12.6909365454545,56
"2305","WI-133125",1988,150,79,9.89124214285714,71
"2306","WI-133125",1989,152,81,10.5433304285714,71
"2307","WI-133125",1990,162,81,10.308017,81
"2308","WI-133125",1991,132,74,9.0231498245614,58
"2309","WI-133125",1992,163,82,10.36526775,81
"2310","WI-133125",1993,162,94,11.598357761194,68
"2311","WI-133125",1994,163,70,9.80200489130435,93
"2312","WI-133125",1995,155,68,8.55366976744186,87
"2313","WI-133125",1996,165,98,10.7221618181818,67
"2314","WI-133125",1997,169,101,11.504011641791,68
"2315","WI-133125",1998,135,81,10.8916803773585,54
"2316","WI-133125",1999,155,74,10.905382625,81
"2317","WI-133125",2000,161,51,10.280078440367,110
"2318","WI-133125",2001,138,87,12.0862944,51
"2319","WI-133125",2002,150,86,9.53982238095238,64
"2320","WI-133125",2003,164,97,12.5608527272727,67
"2321","WI-133125",2004,158,75,11.575622195122,83
"2322","WI-133125",2005,155,80,11.0863704054054,75
"2323","WI-133125",2006,146,83,10.5409243548387,63
"2324","WI-133125",2007,149,100,13.7263085416667,49
"2325","WI-133125",2008,155,74,9.007567125,81
"2326","WI-133125",2009,168,72,10.5123202105263,96
"2327","WI-133125",2010,142,66,9.87291293333333,76
"2328","WI-133125",2011,152,88,10.8247663492063,64
"2329","WI-133125",2012,147,63,12.1392780722892,84
"2330","WI-133125",2013,163,85,10.9361250649351,78
"2331","WI-133125",2014,148,86,10.4802237704918,62
"2332","WI-133125",2015,158,86,12.3072645070423,72
"2333","WI-133125",2016,145,64,8.901547375,81
"2334","WI-133125",2017,160,76,11.7816406024096,84
"2335","WI-133125",2018,144,107,13.0236358333333,37
"2336","WI-133125",2019,175,70,11.2041947115385,105
"2337","WI-133125",2020,145,65,7.3280417721519,80
"2338","WI-133125",2021,140,66,9.01911191780822,74
"2339","WI-133125",2022,130,88,7.55742634146341,42
"2340","WI-133125",2023,150,76,9.84581616438356,74
"2341","WI-133320",1979,157,86,10.4497701428571,71
"2342","WI-133320",1980,148,76,9.27918676056338,72
"2343","WI-133320",1981,155,78,11.282565,77
"2344","WI-133320",1982,134,100,11.2010081818182,34
"2345","WI-133320",1983,161,87,9.02336780821918,74
"2346","WI-133320",1984,156,84,9.26893436619718,72
"2347","WI-133320",1985,174,66,11.857508411215,108
"2348","WI-133320",1986,149,78,10.2135245714286,71
"2349","WI-133320",1987,148,92,12.7532950909091,56
"2350","WI-133320",1988,150,79,9.87171114285714,71
"2351","WI-133320",1989,152,81,10.601813,71
"2352","WI-133320",1990,162,85,10.9877342105263,77
"2353","WI-133320",1991,132,74,9.0759198245614,58
"2354","WI-133320",1992,163,82,10.418295375,81
"2355","WI-133320",1993,162,81,10.135242375,81
"2356","WI-133320",1994,163,70,9.88505456521739,93
"2357","WI-133320",1995,155,68,8.66613255813954,87
"2358","WI-133320",1996,165,98,10.8122425757576,67
"2359","WI-133320",1997,169,101,11.5448232835821,68
"2360","WI-133320",1998,136,80,10.9471570909091,56
"2361","WI-133320",1999,155,74,10.900401625,81
"2362","WI-133320",2000,161,51,10.3392811926606,110
"2363","WI-133320",2001,160,87,12.4042884722222,73
"2364","WI-133320",2002,150,85,9.440783125,65
"2365","WI-133320",2003,164,97,12.5845263636364,67
"2366","WI-133320",2004,158,75,11.6486980487805,83
"2367","WI-133320",2005,155,80,11.0897491891892,75
"2368","WI-133320",2006,146,83,10.4993406451613,63
"2369","WI-133320",2007,149,100,13.7420964583333,49
"2370","WI-133320",2008,155,74,9.023485375,81
"2371","WI-133320",2009,168,72,10.5884727368421,96
"2372","WI-133320",2010,142,66,9.8611416,76
"2373","WI-133320",2011,152,88,10.8809423809524,64
"2374","WI-133320",2012,160,63,12.8844384375,97
"2375","WI-133320",2013,163,85,10.9771153246753,78
"2376","WI-133320",2014,148,85,10.3404056451613,63
"2377","WI-133320",2015,157,86,12.2407205714286,71
"2378","WI-133320",2016,145,64,8.90232775,81
"2379","WI-133320",2017,160,76,11.9153939759036,84
"2380","WI-133320",2018,144,107,13.1275838888889,37
"2381","WI-133320",2019,158,70,10.0124108045977,88
"2382","WI-133320",2020,146,65,7.584320125,81
"2383","WI-133320",2021,140,66,8.89785808219178,74
"2384","WI-133320",2022,130,88,7.56924073170732,42
"2385","WI-133320",2023,150,76,9.7925202739726,74
"2386","WI-143123",1979,168,99,13.0961485294118,69
"2387","WI-143123",1980,148,76,9.02104422535211,72
"2388","WI-143123",1981,156,78,10.7994433766234,78
"2389","WI-143123",1982,134,100,11.0492563636364,34
"2390","WI-143123",1983,161,89,8.81059605633803,72
"2391","WI-143123",1984,156,88,9.66194671641791,68
"2392","WI-143123",1985,175,67,11.6773224299065,108
"2393","WI-143123",1986,149,81,11.0670994029851,68
"2394","WI-143123",1987,148,92,12.4121014545455,56
"2395","WI-143123",1988,150,80,9.82235420289855,70
"2396","WI-143123",1989,170,81,11.7584051136364,89
"2397","WI-143123",1990,115,85,6.0126524137931,30
"2398","WI-143123",1991,132,74,8.6241649122807,58
"2399","WI-143123",1992,164,84,10.5313055696203,80
"2400","WI-143123",1993,162,94,11.1832464179104,68
"2401","WI-143123",1994,163,70,9.45307489130435,93
"2402","WI-143123",1995,155,69,8.34574647058824,86
"2403","WI-143123",1996,165,98,10.3324842424242,67
"2404","WI-143123",1997,170,101,11.4022480882353,69
"2405","WI-143123",1998,136,81,10.826372037037,55
"2406","WI-143123",1999,155,74,10.78223775,81
"2407","WI-143123",2000,161,51,9.97202183486239,110
"2408","WI-143123",2001,161,87,12.2116438356164,74
"2409","WI-143123",2002,160,87,10.44919125,73
"2410","WI-143123",2003,166,97,12.5593727941176,69
"2411","WI-143123",2004,158,79,11.6415485897436,79
"2412","WI-143123",2005,155,81,10.9818289041096,74
"2413","WI-143123",2006,146,83,10.3086901612903,63
"2414","WI-143123",2007,150,100,13.6509991836735,50
"2415","WI-143123",2008,155,83,9.80616929577465,72
"2416","WI-143123",2009,168,73,10.2925024468085,95
"2417","WI-143123",2010,142,66,9.60510053333333,76
"2418","WI-143123",2011,152,88,10.4178968253968,64
"2419","WI-143123",2012,160,63,12.4571928125,97
"2420","WI-143123",2013,163,85,10.525715974026,78
"2421","WI-143123",2014,149,86,10.0865901612903,63
"2422","WI-143123",2015,158,86,11.9366671830986,72
"2423","WI-143123",2016,145,64,8.474106,81
"2424","WI-143123",2017,160,76,11.3306806024096,84
"2425","WI-143123",2018,144,108,13.0415877142857,36
"2426","WI-143123",2019,175,71,10.8615159223301,104
"2427","WI-143123",2020,146,66,7.11981443037975,80
"2428","WI-143123",2021,140,66,8.72694630136986,74
"2429","WI-143123",2022,130,89,7.3161645,41
"2430","WI-143123",2023,150,76,9.56381753424658,74
"2431","WI-143274",1979,169,101,12.2884967164179,68
"2432","WI-143274",1980,175,88,12.4385579069767,87
"2433","WI-143274",1981,162,84,9.78053948051948,78
"2434","WI-143274",1982,184,101,13.6022585365854,83
"2435","WI-143274",1983,162,108,10.319810754717,54
"2436","WI-143274",1984,156,92,9.66904793650794,64
"2437","WI-143274",1985,179,82,13.1422198958333,97
"2438","WI-143274",1986,149,83,10.8683958461538,66
"2439","WI-143274",1987,148,92,12.0882385454545,56
"2440","WI-143274",1988,150,81,9.72779764705882,69
"2441","WI-143274",1989,171,81,11.3165266292135,90
"2442","WI-143274",1990,162,85,10.3947044736842,77
"2443","WI-143274",1991,133,74,8.3745824137931,59
"2444","WI-143274",1992,164,84,10.2106964556962,80
"2445","WI-143274",1993,174,81,10.6336034782609,93
"2446","WI-143274",1994,164,76,9.79741252873563,88
"2447","WI-143274",1995,155,97,9.98198175438596,58
"2448","WI-143274",1996,179,98,11.48744975,81
"2449","WI-143274",1997,170,101,11.1007773529412,69
"2450","WI-143274",1998,136,81,10.5134372222222,55
"2451","WI-143274",1999,156,74,10.6277103703704,82
"2452","WI-143274",2000,161,51,9.64289366972477,110
"2453","WI-143274",2001,161,87,11.872817260274,74
"2454","WI-143274",2002,160,94,10.9685149230769,66
"2455","WI-143274",2003,167,97,12.3708963768116,70
"2456","WI-143274",2004,158,79,11.095073974359,79
"2457","WI-143274",2005,155,81,10.6952282191781,74
"2458","WI-143274",2006,146,83,10.1106053225806,63
"2459","WI-143274",2007,150,100,13.3102787755102,50
"2460","WI-143274",2008,157,86,10.0370808571429,71
"2461","WI-143274",2009,168,73,10.0420037234043,95
"2462","WI-143274",2010,142,66,9.35666266666667,76
"2463","WI-143274",2011,153,88,10.15233578125,65
"2464","WI-143274",2012,160,63,12.0632313541667,97
"2465","WI-143274",2013,164,86,10.4355746753247,78
"2466","WI-143274",2014,150,86,9.67619111111111,64
"2467","WI-143274",2015,163,86,12.1509782894737,77
"2468","WI-143274",2016,145,64,7.98445775,81
"2469","WI-143274",2017,160,76,10.9633044578313,84
"2470","WI-143274",2018,145,108,12.936215,37
"2471","WI-143274",2019,176,73,10.6317115686275,103
"2472","WI-143274",2020,146,67,6.74273961538462,79
"2473","WI-143274",2021,140,66,8.50530671232877,74
"2474","WI-143274",2022,131,89,7.40034658536585,42
"2475","WI-143274",2023,150,77,9.47083611111111,73
"2476","WI-153112",1979,191,101,10.4550447191011,90
"2477","WI-153112",1980,192,94,11.4554164948454,98
"2478","WI-153112",1981,186,82,9.36897223300971,104
"2479","WI-153112",1982,216,102,13.3033260176991,114
"2480","WI-153112",1983,192,108,11.1923891566265,84
"2481","WI-153112",1984,194,94,10.5685683838384,100
"2482","WI-153112",1985,218,92,13.06829648,126
"2483","WI-153112",1986,197,85,10.8999207207207,112
"2484","WI-153112",1987,149,93,8.74082927272727,56
"2485","WI-153112",1988,186,90,10.7485945263158,96
"2486","WI-153112",1989,185,103,10.9568455555556,82
"2487","WI-153112",1990,208,99,12.7882798148148,109
"2488","WI-153112",1991,168,91,10.8398459210526,77
"2489","WI-153112",1992,NA,105,NA,NA
"2490","WI-153112",1993,223,94,12.208743359375,129
"2491","WI-153112",1994,169,99,9.1263068115942,70
"2492","WI-153112",1995,170,98,8.9082385915493,72
"2493","WI-153112",1996,247,106,13.6659108571429,141
"2494","WI-153112",1997,174,105,9.26650808823529,69
"2495","WI-153112",1998,174,83,10.367694,91
"2496","WI-153112",1999,160,86,9.14643246575342,74
"2497","WI-153112",2000,NA,77,NA,NA
"2498","WI-153112",2001,197,90,11.4151045283019,107
"2499","WI-153112",2002,174,97,8.7276375,77
"2500","WI-153112",2003,183,100,10.6249737804878,83
"2501","WI-153112",2004,210,96,11.5117934513274,114
"2502","WI-153112",2005,158,86,7.93584535211268,72
"2503","WI-153112",2006,181,85,11.3866112631579,96
"2504","WI-153112",2007,165,100,11.36760625,65
"2505","WI-153112",2008,197,92,11.2637149038462,105
"2506","WI-153112",2009,173,89,8.7387134939759,84
"2507","WI-153112",2010,185,84,11.5391564,101
"2508","WI-153112",2011,184,91,10.1874039130435,93
"2509","WI-153112",2012,180,68,10.2821741441441,112
"2510","WI-153112",2013,175,95,9.2020329113924,80
"2511","WI-153112",2014,219,107,13.7126527027027,112
"2512","WI-153112",2015,196,90,11.6673832380952,106
"2513","WI-153112",2016,187,98,12.3557646590909,89
"2514","WI-153112",2017,187,81,10.9223265714286,106
"2515","WI-153112",2018,148,107,9.96255725,41
"2516","WI-153112",2019,180,92,9.00830632183908,88
"2517","WI-153112",2020,171,84,8.38160244186047,87
"2518","WI-153112",2021,158,77,8.702683625,81
"2519","WI-153112",2022,173,91,9.48532481481482,82
"2520","WI-153112",2023,152,91,9.21623083333333,61
"2521","WI-163125",1979,190,103,11.5308137209302,87
"2522","WI-163125",1980,175,92,11.9759573170732,83
"2523","WI-163125",1981,183,79,11.0242242718447,104
"2524","WI-163125",1982,185,101,12.1515040963855,84
"2525","WI-163125",1983,173,108,11.07983921875,65
"2526","WI-163125",1984,193,92,12.0056253,101
"2527","WI-163125",1985,185,92,12.2617777173913,93
"2528","WI-163125",1986,186,86,11.9670972727273,100
"2529","WI-163125",1987,150,92,11.5827907017544,58
"2530","WI-163125",1988,150,91,9.47936586206897,59
"2531","WI-163125",1989,171,102,10.7630235294118,69
"2532","WI-163125",1990,178,99,12.1362680769231,79
"2533","WI-163125",1991,133,90,7.90681285714286,43
"2534","WI-163125",1992,NA,104,NA,NA
"2535","WI-163125",1993,209,93,12.1597346086957,116
"2536","WI-163125",1994,168,93,10.6030535135135,75
"2537","WI-163125",1995,166,100,9.63495492307692,66
"2538","WI-163125",1996,180,104,10.5756676,76
"2539","WI-163125",1997,175,101,10.4340332876712,74
"2540","WI-163125",1998,168,81,11.1670852325581,87
"2541","WI-163125",1999,157,85,9.82057492957746,72
"2542","WI-163125",2000,193,78,11.3532952631579,115
"2543","WI-163125",2001,163,89,10.3051902739726,74
"2544","WI-163125",2002,173,96,10.3673668421053,77
"2545","WI-163125",2003,173,98,11.9173535135135,75
"2546","WI-163125",2004,193,84,10.7855346296296,109
"2547","WI-163125",2005,171,86,11.4780679761905,85
"2548","WI-163125",2006,146,86,9.16656372881356,60
"2549","WI-163125",2007,162,101,13.7082163333333,61
"2550","WI-163125",2008,197,91,11.597438952381,106
"2551","WI-163125",2009,169,95,10.3133804109589,74
"2552","WI-163125",2010,142,67,8.31311148648649,75
"2553","WI-163125",2011,179,89,10.6171396629213,90
"2554","WI-163125",2012,179,70,11.6416087962963,109
"2555","WI-163125",2013,173,107,11.5229658461538,66
"2556","WI-163125",2014,190,107,13.4222543902439,83
"2557","WI-163125",2015,191,86,12.6110399038462,105
"2558","WI-163125",2016,169,101,12.5039340298507,68
"2559","WI-163125",2017,161,77,9.46121710843373,84
"2560","WI-163125",2018,144,108,11.5817657142857,36
"2561","WI-163125",2019,178,87,10.0008424444444,91
"2562","WI-163125",2020,171,105,11.6107141538462,66
"2563","WI-163125",2021,154,74,8.49582544303797,80
"2564","WI-163125",2022,168,108,12.171126779661,60
"2565","WI-163125",2023,151,97,10.0511020754717,54
"2566","WI-163238",1979,190,103,11.5308137209302,87
"2567","WI-163238",1980,175,92,11.9759573170732,83
"2568","WI-163238",1981,183,79,11.0242242718447,104
"2569","WI-163238",1982,185,101,12.1515040963855,84
"2570","WI-163238",1983,173,108,11.07983921875,65
"2571","WI-163238",1984,193,92,12.0056253,101
"2572","WI-163238",1985,185,92,12.2617777173913,93
"2573","WI-163238",1986,186,86,11.9670972727273,100
"2574","WI-163238",1987,150,92,11.5827907017544,58
"2575","WI-163238",1988,150,91,9.47936586206897,59
"2576","WI-163238",1989,171,102,10.7630235294118,69
"2577","WI-163238",1990,178,99,12.1362680769231,79
"2578","WI-163238",1991,133,90,7.90681285714286,43
"2579","WI-163238",1992,NA,104,NA,NA
"2580","WI-163238",1993,209,93,12.1597346086957,116
"2581","WI-163238",1994,168,93,10.6030535135135,75
"2582","WI-163238",1995,166,100,9.63495492307692,66
"2583","WI-163238",1996,180,104,10.5756676,76
"2584","WI-163238",1997,175,101,10.4340332876712,74
"2585","WI-163238",1998,168,81,11.1670852325581,87
"2586","WI-163238",1999,157,85,9.82057492957746,72
"2587","WI-163238",2000,193,78,11.3532952631579,115
"2588","WI-163238",2001,163,89,10.3051902739726,74
"2589","WI-163238",2002,173,96,10.3673668421053,77
"2590","WI-163238",2003,173,98,11.9173535135135,75
"2591","WI-163238",2004,193,84,10.7855346296296,109
"2592","WI-163238",2005,171,86,11.4780679761905,85
"2593","WI-163238",2006,146,86,9.16656372881356,60
"2594","WI-163238",2007,162,101,13.7082163333333,61
"2595","WI-163238",2008,197,91,11.597438952381,106
"2596","WI-163238",2009,169,95,10.3133804109589,74
"2597","WI-163238",2010,142,67,8.31311148648649,75
"2598","WI-163238",2011,179,89,10.6171396629213,90
"2599","WI-163238",2012,179,70,11.6416087962963,109
"2600","WI-163238",2013,173,107,11.5229658461538,66
"2601","WI-163238",2014,190,107,13.4222543902439,83
"2602","WI-163238",2015,191,86,12.6110399038462,105
"2603","WI-163238",2016,169,101,12.5039340298507,68
"2604","WI-163238",2017,161,77,9.46121710843373,84
"2605","WI-163238",2018,144,108,11.5817657142857,36
"2606","WI-163238",2019,178,87,10.0008424444444,91
"2607","WI-163238",2020,171,105,11.6107141538462,66
"2608","WI-163238",2021,154,74,8.49582544303797,80
"2609","WI-163238",2022,168,108,12.171126779661,60
"2610","WI-163238",2023,151,97,10.0511020754717,54
"2611","WI-173121",1979,181,99,12.9749155555556,82
"2612","WI-173121",1980,146,84,9.72130196721312,62
"2613","WI-173121",1981,162,67,10.0954540425532,95
"2614","WI-173121",1982,182,100,13.7685192592593,82
"2615","WI-173121",1983,162,86,8.43696266666667,76
"2616","WI-173121",1984,157,82,9.10292067567568,75
"2617","WI-173121",1985,174,70,11.7620987378641,104
"2618","WI-173121",1986,148,83,11.14836484375,65
"2619","WI-173121",1987,149,91,12.9854831578947,58
"2620","WI-173121",1988,150,81,9.93126735294118,69
"2621","WI-173121",1989,170,83,10.9307844186047,87
"2622","WI-173121",1990,162,85,10.573055,77
"2623","WI-173121",1991,133,74,8.00928068965517,59
"2624","WI-173121",1992,163,85,10.1628688311688,78
"2625","WI-173121",1993,184,94,12.3932176404494,90
"2626","WI-173121",1994,164,71,9.49392923913043,93
"2627","WI-173121",1995,154,97,9.80679,57
"2628","WI-173121",1996,164,99,10.16814953125,65
"2629","WI-173121",1997,170,101,11.5370138235294,69
"2630","WI-173121",1998,137,80,11.0442608928571,57
"2631","WI-173121",1999,156,74,10.5174666666667,82
"2632","WI-173121",2000,161,54,9.4608608490566,107
"2633","WI-173121",2001,161,88,11.4682155555556,73
"2634","WI-173121",2002,159,94,10.32352140625,65
"2635","WI-173121",2003,165,98,12.6432836363636,67
"2636","WI-173121",2004,159,81,10.8420516883117,78
"2637","WI-173121",2005,155,84,10.8426807142857,71
"2638","WI-173121",2006,146,85,9.929377,61
"2639","WI-173121",2007,151,101,14.2444093877551,50
"2640","WI-173121",2008,175,87,11.3025998850575,88
"2641","WI-173121",2009,167,74,10.0905809782609,93
"2642","WI-173121",2010,142,66,9.59082973333333,76
"2643","WI-173121",2011,154,89,10.16599109375,65
"2644","WI-173121",2012,158,67,12.5666821111111,91
"2645","WI-173121",2013,164,94,10.5536762318841,70
"2646","WI-173121",2014,148,88,8.62456576271186,60
"2647","WI-173121",2015,158,86,11.5356978873239,72
"2648","WI-173121",2016,146,64,8.33844543209877,82
"2649","WI-173121",2017,156,76,10.5200508860759,80
"2650","WI-173121",2018,144,108,12.590026,36
"2651","WI-173121",2019,157,82,9.44859189189189,75
"2652","WI-173121",2020,146,78,7.20560820895522,68
"2653","WI-173121",2021,140,66,8.33589342465753,74
"2654","WI-173121",2022,131,89,6.65739731707317,42
"2655","WI-173121",2023,151,89,11.0541854098361,62
"2656","WI-173214",1979,189,99,12.6136278651685,90
"2657","WI-173214",1980,146,87,9.53367,59
"2658","WI-173214",1981,178,78,11.6569388888889,100
"2659","WI-173214",1982,184,101,13.403516097561,83
"2660","WI-173214",1983,162,107,10.0695338888889,55
"2661","WI-173214",1984,172,83,10.3527015909091,89
"2662","WI-173214",1985,179,71,11.4162963551402,108
"2663","WI-173214",1986,148,83,10.30644546875,65
"2664","WI-173214",1987,149,92,12.6729416071429,57
"2665","WI-173214",1988,150,83,9.72141924242424,67
"2666","WI-173214",1989,170,100,11.9017673913043,70
"2667","WI-173214",1990,164,85,10.1593343589744,79
"2668","WI-173214",1991,133,75,7.43960105263158,58
"2669","WI-173214",1992,164,85,9.68956166666667,79
"2670","WI-173214",1993,185,94,11.7597674444444,91
"2671","WI-173214",1994,164,87,10.2818448684211,77
"2672","WI-173214",1995,166,97,10.3516304411765,69
"2673","WI-173214",1996,164,102,9.73138557377049,62
"2674","WI-173214",1997,171,101,10.8889863768116,70
"2675","WI-173214",1998,166,81,12.1282175,85
"2676","WI-173214",1999,157,75,10.1789045679012,82
"2677","WI-173214",2000,163,76,10.2320751162791,87
"2678","WI-173214",2001,161,88,10.7263527777778,73
"2679","WI-173214",2002,160,95,9.81517671875,65
"2680","WI-173214",2003,166,98,12.1384335820896,68
"2681","WI-173214",2004,184,81,11.5523296078431,103
"2682","WI-173214",2005,155,84,10.3272787142857,71
"2683","WI-173214",2006,146,85,9.472737,61
"2684","WI-173214",2007,152,101,13.7565034,51
"2685","WI-173214",2008,186,91,11.9864143617021,95
"2686","WI-173214",2009,167,89,10.5748919480519,78
"2687","WI-173214",2010,142,66,8.96635066666667,76
"2688","WI-173214",2011,156,89,9.80906636363636,67
"2689","WI-173214",2012,158,68,11.794315505618,90
"2690","WI-173214",2013,171,95,10.6405330666667,76
"2691","WI-173214",2014,148,94,8.6521658490566,54
"2692","WI-173214",2015,175,86,12.3394407954545,89
"2693","WI-173214",2016,148,97,10.8501648,51
"2694","WI-173214",2017,156,77,9.83156794871795,79
"2695","WI-173214",2018,144,109,12.4351008823529,35
"2696","WI-173214",2019,157,82,8.63007513513513,75
"2697","WI-173214",2020,157,107,11.2894116326531,50
"2698","WI-173214",2021,140,66,7.39175808219178,74
"2699","WI-173214",2022,164,90,10.3943482191781,74
"2700","WI-173214",2023,150,91,10.6617217241379,59
"2701","WI-173215",1979,189,99,12.6136278651685,90
"2702","WI-173215",1980,146,87,9.53367,59
"2703","WI-173215",1981,178,78,11.6569388888889,100
"2704","WI-173215",1982,184,101,13.403516097561,83
"2705","WI-173215",1983,162,107,10.0695338888889,55
"2706","WI-173215",1984,172,83,10.3527015909091,89
"2707","WI-173215",1985,179,71,11.4162963551402,108
"2708","WI-173215",1986,148,83,10.30644546875,65
"2709","WI-173215",1987,149,92,12.6729416071429,57
"2710","WI-173215",1988,150,83,9.72141924242424,67
"2711","WI-173215",1989,170,100,11.9017673913043,70
"2712","WI-173215",1990,164,85,10.1593343589744,79
"2713","WI-173215",1991,133,75,7.43960105263158,58
"2714","WI-173215",1992,164,85,9.68956166666667,79
"2715","WI-173215",1993,185,94,11.7597674444444,91
"2716","WI-173215",1994,164,87,10.2818448684211,77
"2717","WI-173215",1995,166,97,10.3516304411765,69
"2718","WI-173215",1996,164,102,9.73138557377049,62
"2719","WI-173215",1997,171,101,10.8889863768116,70
"2720","WI-173215",1998,166,81,12.1282175,85
"2721","WI-173215",1999,157,75,10.1789045679012,82
"2722","WI-173215",2000,163,76,10.2320751162791,87
"2723","WI-173215",2001,161,88,10.7263527777778,73
"2724","WI-173215",2002,160,95,9.81517671875,65
"2725","WI-173215",2003,166,98,12.1384335820896,68
"2726","WI-173215",2004,184,81,11.5523296078431,103
"2727","WI-173215",2005,155,84,10.3272787142857,71
"2728","WI-173215",2006,146,85,9.472737,61
"2729","WI-173215",2007,152,101,13.7565034,51
"2730","WI-173215",2008,186,91,11.9864143617021,95
"2731","WI-173215",2009,167,89,10.5748919480519,78
"2732","WI-173215",2010,142,66,8.96635066666667,76
"2733","WI-173215",2011,156,89,9.80906636363636,67
"2734","WI-173215",2012,158,68,11.794315505618,90
"2735","WI-173215",2013,171,95,10.6405330666667,76
"2736","WI-173215",2014,148,94,8.6521658490566,54
"2737","WI-173215",2015,175,86,12.3394407954545,89
"2738","WI-173215",2016,148,97,10.8501648,51
"2739","WI-173215",2017,156,77,9.83156794871795,79
"2740","WI-173215",2018,144,109,12.4351008823529,35
"2741","WI-173215",2019,157,82,8.63007513513513,75
"2742","WI-173215",2020,157,107,11.2894116326531,50
"2743","WI-173215",2021,140,66,7.39175808219178,74
"2744","WI-173215",2022,164,90,10.3943482191781,74
"2745","WI-173215",2023,150,91,10.6617217241379,59
"2746","WI-173216",1979,181,99,12.9749155555556,82
"2747","WI-173216",1980,146,84,9.72130196721312,62
"2748","WI-173216",1981,162,67,10.0954540425532,95
"2749","WI-173216",1982,182,100,13.7685192592593,82
"2750","WI-173216",1983,162,86,8.43696266666667,76
"2751","WI-173216",1984,157,82,9.10292067567568,75
"2752","WI-173216",1985,174,70,11.7620987378641,104
"2753","WI-173216",1986,148,83,11.14836484375,65
"2754","WI-173216",1987,149,91,12.9854831578947,58
"2755","WI-173216",1988,150,81,9.93126735294118,69
"2756","WI-173216",1989,170,83,10.9307844186047,87
"2757","WI-173216",1990,162,85,10.573055,77
"2758","WI-173216",1991,133,74,8.00928068965517,59
"2759","WI-173216",1992,163,85,10.1628688311688,78
"2760","WI-173216",1993,184,94,12.3932176404494,90
"2761","WI-173216",1994,164,71,9.49392923913043,93
"2762","WI-173216",1995,154,97,9.80679,57
"2763","WI-173216",1996,164,99,10.16814953125,65
"2764","WI-173216",1997,170,101,11.5370138235294,69
"2765","WI-173216",1998,137,80,11.0442608928571,57
"2766","WI-173216",1999,156,74,10.5174666666667,82
"2767","WI-173216",2000,161,54,9.4608608490566,107
"2768","WI-173216",2001,161,88,11.4682155555556,73
"2769","WI-173216",2002,159,94,10.32352140625,65
"2770","WI-173216",2003,165,98,12.6432836363636,67
"2771","WI-173216",2004,159,81,10.8420516883117,78
"2772","WI-173216",2005,155,84,10.8426807142857,71
"2773","WI-173216",2006,146,85,9.929377,61
"2774","WI-173216",2007,151,101,14.2444093877551,50
"2775","WI-173216",2008,175,87,11.3025998850575,88
"2776","WI-173216",2009,167,74,10.0905809782609,93
"2777","WI-173216",2010,142,66,9.59082973333333,76
"2778","WI-173216",2011,154,89,10.16599109375,65
"2779","WI-173216",2012,158,67,12.5666821111111,91
"2780","WI-173216",2013,164,94,10.5536762318841,70
"2781","WI-173216",2014,148,88,8.62456576271186,60
"2782","WI-173216",2015,158,86,11.5356978873239,72
"2783","WI-173216",2016,146,64,8.33844543209877,82
"2784","WI-173216",2017,156,76,10.5200508860759,80
"2785","WI-173216",2018,144,108,12.590026,36
"2786","WI-173216",2019,157,82,9.44859189189189,75
"2787","WI-173216",2020,146,78,7.20560820895522,68
"2788","WI-173216",2021,140,66,8.33589342465753,74
"2789","WI-173216",2022,131,89,6.65739731707317,42
"2790","WI-173216",2023,151,89,11.0541854098361,62
"2791","WI-193006",1979,190,123,11.6323934848485,67
"2792","WI-193006",1980,175,106,12.3908377941176,69
"2793","WI-193006",1981,185,86,10.7278326530612,99
"2794","WI-193006",1982,187,102,12.3458072619048,85
"2795","WI-193006",1983,173,109,10.3622004761905,64
"2796","WI-193006",1984,193,100,11.7107690217391,93
"2797","WI-193006",1985,218,99,14.4504555932203,119
"2798","WI-193006",1986,187,86,11.6887715,101
"2799","WI-193006",1987,149,93,11.0757723636364,56
"2800","WI-193006",1988,150,86,8.43454666666667,64
"2801","WI-193006",1989,184,102,11.8092956790123,82
"2802","WI-193006",1990,182,99,12.1135732926829,83
"2803","WI-193006",1991,168,90,12.2669,78
"2804","WI-193006",1992,NA,105,NA,NA
"2805","WI-193006",1993,187,93,10.2143315053763,94
"2806","WI-193006",1994,165,94,9.57219657142857,71
"2807","WI-193006",1995,167,98,9.16822220588235,69
"2808","WI-193006",1996,180,106,9.94338684931507,74
"2809","WI-193006",1997,173,104,9.71439691176471,69
"2810","WI-193006",1998,169,82,11.1405520930233,87
"2811","WI-193006",1999,158,86,10.0491481690141,72
"2812","WI-193006",2000,211,78,12.1117493181818,133
"2813","WI-193006",2001,163,89,10.1887508219178,74
"2814","WI-193006",2002,173,97,9.8695748,76
"2815","WI-193006",2003,174,98,11.504344,76
"2816","WI-193006",2004,194,93,11.1210572,101
"2817","WI-193006",2005,157,86,9.699921,71
"2818","WI-193006",2006,147,86,8.94258116666667,61
"2819","WI-193006",2007,152,100,12.2482694117647,52
"2820","WI-193006",2008,191,92,11.6231112244898,99
"2821","WI-193006",2009,170,98,10.2712832394366,72
"2822","WI-193006",2010,142,65,8.06541736842105,77
"2823","WI-193006",2011,180,89,10.7462883333333,91
"2824","WI-193006",2012,169,69,10.573247979798,100
"2825","WI-193006",2013,173,94,10.2964448717949,79
"2826","WI-193006",2014,178,93,11.188344047619,85
"2827","WI-193006",2015,192,88,12.230564368932,104
"2828","WI-193006",2016,187,102,13.613460952381,85
"2829","WI-193006",2017,161,78,8.99352390243902,83
"2830","WI-193006",2018,145,108,11.1443308333333,37
"2831","WI-193006",2019,178,92,9.95894188235294,86
"2832","WI-193006",2020,146,110,7.54706285714286,36
"2833","WI-193006",2021,155,77,8.93230987012987,78
"2834","WI-193006",2022,169,109,12.5209174576271,60
"2835","WI-193006",2023,150,91,9.85595620689655,59
"2836","WI-193012",1979,190,122,12.1562626865672,68
"2837","WI-193012",1980,175,105,12.3564366666667,70
"2838","WI-193012",1981,185,84,10.7379687,101
"2839","WI-193012",1982,187,102,12.4377903571429,85
"2840","WI-193012",1983,173,111,10.5801090163934,62
"2841","WI-193012",1984,193,92,11.4970317,101
"2842","WI-193012",1985,217,98,14.4585388135593,119
"2843","WI-193012",1986,187,86,11.8386937,101
"2844","WI-193012",1987,149,93,11.1192383636364,56
"2845","WI-193012",1988,150,85,8.46006984375,65
"2846","WI-193012",1989,184,101,11.8284270731707,83
"2847","WI-193012",1990,182,99,12.3206982926829,83
"2848","WI-193012",1991,150,90,10.4967015254237,60
"2849","WI-193012",1992,NA,105,NA,NA
"2850","WI-193012",1993,187,93,10.347815483871,94
"2851","WI-193012",1994,165,88,8.99559105263158,77
"2852","WI-193012",1995,167,98,9.26059352941176,69
"2853","WI-193012",1996,180,106,10.0919320547945,74
"2854","WI-193012",1997,173,103,9.67882768115942,70
"2855","WI-193012",1998,169,82,11.3345931395349,87
"2856","WI-193012",1999,158,85,10.3637151388889,73
"2857","WI-193012",2000,211,78,12.248409469697,133
"2858","WI-193012",2001,163,88,10.1302613513514,75
"2859","WI-193012",2002,173,97,10.0822828,76
"2860","WI-193012",2003,174,98,11.5086156,76
"2861","WI-193012",2004,194,82,10.5374963963964,112
"2862","WI-193012",2005,156,85,9.52551785714286,71
"2863","WI-193012",2006,147,85,8.95757475409836,62
"2864","WI-193012",2007,151,100,12.1282842,51
"2865","WI-193012",2008,191,91,11.775514040404,100
"2866","WI-193012",2009,170,90,9.59456367088608,80
"2867","WI-193012",2010,142,64,8.06898896103896,78
"2868","WI-193012",2011,180,89,10.8668614444444,91
"2869","WI-193012",2012,169,68,10.6612638,101
"2870","WI-193012",2013,173,94,10.5226062820513,79
"2871","WI-193012",2014,178,91,11.1894854651163,87
"2872","WI-193012",2015,192,88,12.4147269902913,104
"2873","WI-193012",2016,186,102,13.6663553012048,84
"2874","WI-193012",2017,160,78,8.99506543209877,82
"2875","WI-193012",2018,145,108,11.3489752777778,37
"2876","WI-193012",2019,178,92,10.1693277647059,86
"2877","WI-193012",2020,171,110,11.5516511666667,61
"2878","WI-193012",2021,142,75,7.74953196969697,67
"2879","WI-193012",2022,169,107,12.3721831147541,62
"2880","WI-193012",2023,150,91,10.0303901724138,59
"2881","WI-193027",1979,191,123,11.2318814925373,68
"2882","WI-193027",1980,175,106,11.9667797058824,69
"2883","WI-193027",1981,185,85,10.2996517171717,100
"2884","WI-193027",1982,187,102,12.109944047619,85
"2885","WI-193027",1983,173,110,10.2401137096774,63
"2886","WI-193027",1984,194,100,11.310968172043,94
"2887","WI-193027",1985,NA,99,NA,NA
"2888","WI-193027",1986,188,86,11.5838376237624,102
"2889","WI-193027",1987,150,93,11.0450366071429,57
"2890","WI-193027",1988,150,86,8.15850476190476,64
"2891","WI-193027",1989,184,102,11.5141565432099,82
"2892","WI-193027",1990,182,99,11.7921165853659,83
"2893","WI-193027",1991,177,90,12.4900289534884,87
"2894","WI-193027",1992,NA,105,NA,NA
"2895","WI-193027",1993,223,94,12.1610140625,129
"2896","WI-193027",1994,165,95,9.42253391304348,70
"2897","WI-193027",1995,167,99,8.92354298507463,68
"2898","WI-193027",1996,181,106,9.94604513513513,75
"2899","WI-193027",1997,173,105,9.44387880597015,68
"2900","WI-193027",1998,174,82,11.4192821978022,92
"2901","WI-193027",1999,158,86,9.98411718309859,72
"2902","WI-193027",2000,225,101,13.9620098373984,124
"2903","WI-193027",2001,163,89,9.81867465753425,74
"2904","WI-193027",2002,173,97,9.7214504,76
"2905","WI-193027",2003,183,98,11.924184047619,85
"2906","WI-193027",2004,195,93,10.9391900990099,102
"2907","WI-193027",2005,157,85,9.28418464788732,72
"2908","WI-193027",2006,147,86,8.57930033333333,61
"2909","WI-193027",2007,163,101,12.9700052459016,62
"2910","WI-193027",2008,199,92,11.6680346226415,107
"2911","WI-193027",2009,171,99,10.2280256338028,72
"2912","WI-193027",2010,142,65,7.74253605263158,77
"2913","WI-193027",2011,180,90,10.5002426966292,90
"2914","WI-193027",2012,169,68,10.1943108,101
"2915","WI-193027",2013,173,104,11.2416392647059,69
"2916","WI-193027",2014,178,106,12.4144408450704,72
"2917","WI-193027",2015,194,97,12.9706627083333,97
"2918","WI-193027",2016,188,102,13.447032,86
"2919","WI-193027",2017,161,79,8.66050111111111,82
"2920","WI-193027",2018,145,109,11.0500697142857,36
"2921","WI-193027",2019,179,103,10.9429394666667,76
"2922","WI-193027",2020,180,111,12.1805373529412,69
"2923","WI-193027",2021,155,77,8.49988311688312,78
"2924","WI-193027",2022,169,109,12.1847147457627,60
"2925","WI-193027",2023,151,94,9.92225482142857,57
"2926","WI-194004",1979,190,123,11.6323934848485,67
"2927","WI-194004",1980,175,106,12.3908377941176,69
"2928","WI-194004",1981,185,86,10.7278326530612,99
"2929","WI-194004",1982,187,102,12.3458072619048,85
"2930","WI-194004",1983,173,109,10.3622004761905,64
"2931","WI-194004",1984,193,100,11.7107690217391,93
"2932","WI-194004",1985,218,99,14.4504555932203,119
"2933","WI-194004",1986,187,86,11.6887715,101
"2934","WI-194004",1987,149,93,11.0757723636364,56
"2935","WI-194004",1988,150,86,8.43454666666667,64
"2936","WI-194004",1989,184,102,11.8092956790123,82
"2937","WI-194004",1990,182,99,12.1135732926829,83
"2938","WI-194004",1991,168,90,12.2669,78
"2939","WI-194004",1992,NA,105,NA,NA
"2940","WI-194004",1993,187,93,10.2143315053763,94
"2941","WI-194004",1994,165,94,9.57219657142857,71
"2942","WI-194004",1995,167,98,9.16822220588235,69
"2943","WI-194004",1996,180,106,9.94338684931507,74
"2944","WI-194004",1997,173,104,9.71439691176471,69
"2945","WI-194004",1998,169,82,11.1405520930233,87
"2946","WI-194004",1999,158,86,10.0491481690141,72
"2947","WI-194004",2000,211,78,12.1117493181818,133
"2948","WI-194004",2001,163,89,10.1887508219178,74
"2949","WI-194004",2002,173,97,9.8695748,76
"2950","WI-194004",2003,174,98,11.504344,76
"2951","WI-194004",2004,194,93,11.1210572,101
"2952","WI-194004",2005,157,86,9.699921,71
"2953","WI-194004",2006,147,86,8.94258116666667,61
"2954","WI-194004",2007,152,100,12.2482694117647,52
"2955","WI-194004",2008,191,92,11.6231112244898,99
"2956","WI-194004",2009,170,98,10.2712832394366,72
"2957","WI-194004",2010,142,65,8.06541736842105,77
"2958","WI-194004",2011,180,89,10.7462883333333,91
"2959","WI-194004",2012,169,69,10.573247979798,100
"2960","WI-194004",2013,173,94,10.2964448717949,79
"2961","WI-194004",2014,178,93,11.188344047619,85
"2962","WI-194004",2015,192,88,12.230564368932,104
"2963","WI-194004",2016,187,102,13.613460952381,85
"2964","WI-194004",2017,161,78,8.99352390243902,83
"2965","WI-194004",2018,145,108,11.1443308333333,37
"2966","WI-194004",2019,178,92,9.95894188235294,86
"2967","WI-194004",2020,146,110,7.54706285714286,36
"2968","WI-194004",2021,155,77,8.93230987012987,78
"2969","WI-194004",2022,169,109,12.5209174576271,60
"2970","WI-194004",2023,150,91,9.85595620689655,59
"2971","WI-203079",1979,190,101,13.2215661363636,89
"2972","WI-203079",1980,175,88,12.1092523255814,87
"2973","WI-203079",1981,163,84,9.44350769230769,79
"2974","WI-203079",1982,184,102,14.0618572839506,82
"2975","WI-203079",1983,162,109,10.1167863461538,53
"2976","WI-203079",1984,156,93,9.59271822580645,63
"2977","WI-203079",1985,180,82,12.9798370103093,98
"2978","WI-203079",1986,170,83,12.2091620930233,87
"2979","WI-203079",1987,148,92,11.7288634545455,56
"2980","WI-203079",1988,150,81,9.45493455882353,69
"2981","WI-203079",1989,171,81,11.0861887640449,90
"2982","WI-203079",1990,162,85,10.2181005263158,77
"2983","WI-203079",1991,133,74,8.37700689655172,59
"2984","WI-203079",1992,166,84,10.2527969135802,82
"2985","WI-203079",1993,174,81,10.5298325,93
"2986","WI-203079",1994,164,76,9.55872701149425,88
"2987","WI-203079",1995,166,97,10.9747925,69
"2988","WI-203079",1996,179,99,11.4577907594937,80
"2989","WI-203079",1997,170,101,10.8212511764706,69
"2990","WI-203079",1998,136,81,10.3155216666667,55
"2991","WI-203079",1999,156,74,10.4270925925926,82
"2992","WI-203079",2000,162,51,9.70309672727273,111
"2993","WI-203079",2001,161,87,11.6857443835616,74
"2994","WI-203079",2002,161,94,10.9426956060606,67
"2995","WI-203079",2003,173,97,12.4943486666667,76
"2996","WI-203079",2004,159,79,11.0405660759494,80
"2997","WI-203079",2005,155,81,10.5277406849315,74
"2998","WI-203079",2006,146,82,9.93000317460317,64
"2999","WI-203079",2007,150,100,13.0081420408163,50
"3000","WI-203079",2008,157,86,10.0185534285714,71
"3001","WI-203079",2009,169,73,9.92591284210526,96
"3002","WI-203079",2010,143,66,9.25162960526316,77
"3003","WI-203079",2011,153,88,10.0894696875,65
"3004","WI-203079",2012,161,63,11.9096992783505,98
"3005","WI-203079",2013,165,85,10.3993582278481,80
"3006","WI-203079",2014,150,86,9.71017,64
"3007","WI-203079",2015,167,86,12.418611125,81
"3008","WI-203079",2016,145,64,7.88377425,81
"3009","WI-203079",2017,160,77,10.9127065853659,83
"3010","WI-203079",2018,145,108,12.6968480555556,37
"3011","WI-203079",2019,176,71,10.3790207692308,105
"3012","WI-203079",2020,146,68,6.69896077922078,78
"3013","WI-203079",2021,140,66,8.41070068493151,74
"3014","WI-203079",2022,131,89,7.34489731707317,42
"3015","WI-203079",2023,150,76,9.25538493150685,74
"3016","WI-213040",1979,191,123,11.2318814925373,68
"3017","WI-213040",1980,175,106,11.9667797058824,69
"3018","WI-213040",1981,185,85,10.2996517171717,100
"3019","WI-213040",1982,187,102,12.109944047619,85
"3020","WI-213040",1983,173,110,10.2401137096774,63
"3021","WI-213040",1984,194,100,11.310968172043,94
"3022","WI-213040",1985,NA,99,NA,NA
"3023","WI-213040",1986,188,86,11.5838376237624,102
"3024","WI-213040",1987,150,93,11.0450366071429,57
"3025","WI-213040",1988,150,86,8.15850476190476,64
"3026","WI-213040",1989,184,102,11.5141565432099,82
"3027","WI-213040",1990,182,99,11.7921165853659,83
"3028","WI-213040",1991,177,90,12.4900289534884,87
"3029","WI-213040",1992,NA,105,NA,NA
"3030","WI-213040",1993,223,94,12.1610140625,129
"3031","WI-213040",1994,165,95,9.42253391304348,70
"3032","WI-213040",1995,167,99,8.92354298507463,68
"3033","WI-213040",1996,181,106,9.94604513513513,75
"3034","WI-213040",1997,173,105,9.44387880597015,68
"3035","WI-213040",1998,174,82,11.4192821978022,92
"3036","WI-213040",1999,158,86,9.98411718309859,72
"3037","WI-213040",2000,225,101,13.9620098373984,124
"3038","WI-213040",2001,163,89,9.81867465753425,74
"3039","WI-213040",2002,173,97,9.7214504,76
"3040","WI-213040",2003,183,98,11.924184047619,85
"3041","WI-213040",2004,195,93,10.9391900990099,102
"3042","WI-213040",2005,157,85,9.28418464788732,72
"3043","WI-213040",2006,147,86,8.57930033333333,61
"3044","WI-213040",2007,163,101,12.9700052459016,62
"3045","WI-213040",2008,199,92,11.6680346226415,107
"3046","WI-213040",2009,171,99,10.2280256338028,72
"3047","WI-213040",2010,142,65,7.74253605263158,77
"3048","WI-213040",2011,180,90,10.5002426966292,90
"3049","WI-213040",2012,169,68,10.1943108,101
"3050","WI-213040",2013,173,104,11.2416392647059,69
"3051","WI-213040",2014,178,106,12.4144408450704,72
"3052","WI-213040",2015,194,97,12.9706627083333,97
"3053","WI-213040",2016,188,102,13.447032,86
"3054","WI-213040",2017,161,79,8.66050111111111,82
"3055","WI-213040",2018,145,109,11.0500697142857,36
"3056","WI-213040",2019,179,103,10.9429394666667,76
"3057","WI-213040",2020,180,111,12.1805373529412,69
"3058","WI-213040",2021,155,77,8.49988311688312,78
"3059","WI-213040",2022,169,109,12.1847147457627,60
"3060","WI-213040",2023,151,94,9.92225482142857,57
"3061","WI-213123",1979,190,104,10.5601154117647,86
"3062","WI-213123",1980,175,106,12.1171707352941,69
"3063","WI-213123",1981,185,83,10.5353145544554,102
"3064","WI-213123",1982,185,102,12.1653590243902,83
"3065","WI-213123",1983,173,109,10.4393331746032,64
"3066","WI-213123",1984,193,96,11.5140084375,97
"3067","WI-213123",1985,218,99,14.6470922881356,119
"3068","WI-213123",1986,187,85,11.7806732673267,102
"3069","WI-213123",1987,149,93,11.2058854545455,56
"3070","WI-213123",1988,150,85,8.40220859375,65
"3071","WI-213123",1989,172,102,10.8723565217391,70
"3072","WI-213123",1990,180,99,11.942795,81
"3073","WI-213123",1991,150,90,10.4691598305085,60
"3074","WI-213123",1992,NA,105,NA,NA
"3075","WI-213123",1993,187,94,10.5096084782609,93
"3076","WI-213123",1994,165,94,9.62866971428571,71
"3077","WI-213123",1995,167,98,9.19280941176471,69
"3078","WI-213123",1996,181,106,10.4512174324324,75
"3079","WI-213123",1997,173,104,9.76207632352941,69
"3080","WI-213123",1998,169,82,11.3632091860465,87
"3081","WI-213123",1999,158,85,10.6068779166667,73
"3082","WI-213123",2000,223,78,12.7106988888889,145
"3083","WI-213123",2001,162,89,9.95415805555556,73
"3084","WI-213123",2002,173,97,10.1844702666667,76
"3085","WI-213123",2003,183,98,12.1807873809524,85
"3086","WI-213123",2004,195,93,11.4323064356436,102
"3087","WI-213123",2005,156,84,9.34963901408451,72
"3088","WI-213123",2006,147,85,8.80119737704918,62
"3089","WI-213123",2007,163,101,13.2705937704918,62
"3090","WI-213123",2008,191,91,11.5016032323232,100
"3091","WI-213123",2009,170,90,9.60366202531646,80
"3092","WI-213123",2010,142,66,8.06343426666667,76
"3093","WI-213123",2011,157,90,8.75765121212121,67
"3094","WI-213123",2012,169,68,10.5622791,101
"3095","WI-213123",2013,173,103,11.3377371014493,70
"3096","WI-213123",2014,178,106,12.7587405633803,72
"3097","WI-213123",2015,194,88,12.3698064761905,106
"3098","WI-213123",2016,187,101,13.5752623529412,86
"3099","WI-213123",2017,161,78,8.99562,83
"3100","WI-213123",2018,145,108,11.0768394444444,37
"3101","WI-213123",2019,178,92,10.1344017647059,86
"3102","WI-213123",2020,180,110,12.3825131884058,70
"3103","WI-213123",2021,155,75,8.73246860759494,80
"3104","WI-213123",2022,169,108,12.3826765,61
"3105","WI-213123",2023,151,91,9.76438627118644,60
"3106","WI-213124",1979,190,104,10.5601154117647,86
"3107","WI-213124",1980,175,106,12.1171707352941,69
"3108","WI-213124",1981,185,83,10.5353145544554,102
"3109","WI-213124",1982,185,102,12.1653590243902,83
"3110","WI-213124",1983,173,109,10.4393331746032,64
"3111","WI-213124",1984,193,96,11.5140084375,97
"3112","WI-213124",1985,218,99,14.6470922881356,119
"3113","WI-213124",1986,187,85,11.7806732673267,102
"3114","WI-213124",1987,149,93,11.2058854545455,56
"3115","WI-213124",1988,150,85,8.40220859375,65
"3116","WI-213124",1989,172,102,10.8723565217391,70
"3117","WI-213124",1990,180,99,11.942795,81
"3118","WI-213124",1991,150,90,10.4691598305085,60
"3119","WI-213124",1992,NA,105,NA,NA
"3120","WI-213124",1993,187,94,10.5096084782609,93
"3121","WI-213124",1994,165,94,9.62866971428571,71
"3122","WI-213124",1995,167,98,9.19280941176471,69
"3123","WI-213124",1996,181,106,10.4512174324324,75
"3124","WI-213124",1997,173,104,9.76207632352941,69
"3125","WI-213124",1998,169,82,11.3632091860465,87
"3126","WI-213124",1999,158,85,10.6068779166667,73
"3127","WI-213124",2000,223,78,12.7106988888889,145
"3128","WI-213124",2001,162,89,9.95415805555556,73
"3129","WI-213124",2002,173,97,10.1844702666667,76
"3130","WI-213124",2003,183,98,12.1807873809524,85
"3131","WI-213124",2004,195,93,11.4323064356436,102
"3132","WI-213124",2005,156,84,9.34963901408451,72
"3133","WI-213124",2006,147,85,8.80119737704918,62
"3134","WI-213124",2007,163,101,13.2705937704918,62
"3135","WI-213124",2008,191,91,11.5016032323232,100
"3136","WI-213124",2009,170,90,9.60366202531646,80
"3137","WI-213124",2010,142,66,8.06343426666667,76
"3138","WI-213124",2011,157,90,8.75765121212121,67
"3139","WI-213124",2012,169,68,10.5622791,101
"3140","WI-213124",2013,173,103,11.3377371014493,70
"3141","WI-213124",2014,178,106,12.7587405633803,72
"3142","WI-213124",2015,194,88,12.3698064761905,106
"3143","WI-213124",2016,187,101,13.5752623529412,86
"3144","WI-213124",2017,161,78,8.99562,83
"3145","WI-213124",2018,145,108,11.0768394444444,37
"3146","WI-213124",2019,178,92,10.1344017647059,86
"3147","WI-213124",2020,180,110,12.3825131884058,70
"3148","WI-213124",2021,155,75,8.73246860759494,80
"3149","WI-213124",2022,169,108,12.3826765,61
"3150","WI-213124",2023,151,91,9.76438627118644,60
"3151","WI-213137",1979,190,123,9.27550424242424,67
"3152","WI-213137",1980,175,107,12.2169789552239,68
"3153","WI-213137",1981,185,94,10.9526598888889,91
"3154","WI-213137",1982,186,102,12.30282,84
"3155","WI-213137",1983,173,110,10.5649625806452,63
"3156","WI-213137",1984,193,101,11.1549350549451,92
"3157","WI-213137",1985,218,99,14.5675772881356,119
"3158","WI-213137",1986,187,86,11.7986157,101
"3159","WI-213137",1987,150,93,11.3681392857143,57
"3160","WI-213137",1988,150,86,8.39573174603175,64
"3161","WI-213137",1989,172,102,10.696971884058,70
"3162","WI-213137",1990,180,99,11.81574475,81
"3163","WI-213137",1991,150,91,10.5253972413793,59
"3164","WI-213137",1992,NA,105,NA,NA
"3165","WI-213137",1993,222,94,12.3352075590551,128
"3166","WI-213137",1994,165,95,9.66721144927536,70
"3167","WI-213137",1995,167,98,9.04092397058823,69
"3168","WI-213137",1996,181,106,10.3119651351351,75
"3169","WI-213137",1997,173,104,9.64902544117647,69
"3170","WI-213137",1998,169,82,11.2465665116279,87
"3171","WI-213137",1999,158,86,10.3031087323944,72
"3172","WI-213137",2000,224,78,12.6345162068966,146
"3173","WI-213137",2001,162,89,9.88265152777778,73
"3174","WI-213137",2002,173,97,10.0094702666667,76
"3175","WI-213137",2003,183,98,12.1818104761905,85
"3176","WI-213137",2004,195,93,11.2915266336634,102
"3177","WI-213137",2005,156,85,9.42306157142857,71
"3178","WI-213137",2006,147,86,8.75026333333333,61
"3179","WI-213137",2007,163,101,13.2069418032787,62
"3180","WI-213137",2008,191,92,11.4064337755102,99
"3181","WI-213137",2009,170,98,10.3929821126761,72
"3182","WI-213137",2010,142,65,7.91626026315789,77
"3183","WI-213137",2011,157,90,8.70533060606061,67
"3184","WI-213137",2012,169,68,10.3409509,101
"3185","WI-213137",2013,173,104,11.3824938235294,69
"3186","WI-213137",2014,177,107,12.6806131884058,70
"3187","WI-213137",2015,193,88,12.1664646153846,105
"3188","WI-213137",2016,188,101,13.6019837209302,87
"3189","WI-213137",2017,161,78,8.84727829268293,83
"3190","WI-213137",2018,145,109,11.2163648571429,36
"3191","WI-213137",2019,178,103,11.1356860810811,75
"3192","WI-213137",2020,179,111,12.3406734328358,68
"3193","WI-213137",2021,155,76,8.59794012820513,79
"3194","WI-213137",2022,169,109,12.3724794915254,60
"3195","WI-213137",2023,151,95,10.0410343636364,56
"3196","WI-213138",1979,190,123,9.27550424242424,67
"3197","WI-213138",1980,175,107,12.2169789552239,68
"3198","WI-213138",1981,185,94,10.9526598888889,91
"3199","WI-213138",1982,186,102,12.30282,84
"3200","WI-213138",1983,173,110,10.5649625806452,63
"3201","WI-213138",1984,193,101,11.1549350549451,92
"3202","WI-213138",1985,218,99,14.5675772881356,119
"3203","WI-213138",1986,187,86,11.7986157,101
"3204","WI-213138",1987,150,93,11.3681392857143,57
"3205","WI-213138",1988,150,86,8.39573174603175,64
"3206","WI-213138",1989,172,102,10.696971884058,70
"3207","WI-213138",1990,180,99,11.81574475,81
"3208","WI-213138",1991,150,91,10.5253972413793,59
"3209","WI-213138",1992,NA,105,NA,NA
"3210","WI-213138",1993,222,94,12.3352075590551,128
"3211","WI-213138",1994,165,95,9.66721144927536,70
"3212","WI-213138",1995,167,98,9.04092397058823,69
"3213","WI-213138",1996,181,106,10.3119651351351,75
"3214","WI-213138",1997,173,104,9.64902544117647,69
"3215","WI-213138",1998,169,82,11.2465665116279,87
"3216","WI-213138",1999,158,86,10.3031087323944,72
"3217","WI-213138",2000,224,78,12.6345162068966,146
"3218","WI-213138",2001,162,89,9.88265152777778,73
"3219","WI-213138",2002,173,97,10.0094702666667,76
"3220","WI-213138",2003,183,98,12.1818104761905,85
"3221","WI-213138",2004,195,93,11.2915266336634,102
"3222","WI-213138",2005,156,85,9.42306157142857,71
"3223","WI-213138",2006,147,86,8.75026333333333,61
"3224","WI-213138",2007,163,101,13.2069418032787,62
"3225","WI-213138",2008,191,92,11.4064337755102,99
"3226","WI-213138",2009,170,98,10.3929821126761,72
"3227","WI-213138",2010,142,65,7.91626026315789,77
"3228","WI-213138",2011,157,90,8.70533060606061,67
"3229","WI-213138",2012,169,68,10.3409509,101
"3230","WI-213138",2013,173,104,11.3824938235294,69
"3231","WI-213138",2014,177,107,12.6806131884058,70
"3232","WI-213138",2015,193,88,12.1664646153846,105
"3233","WI-213138",2016,188,101,13.6019837209302,87
"3234","WI-213138",2017,161,78,8.84727829268293,83
"3235","WI-213138",2018,145,109,11.2163648571429,36
"3236","WI-213138",2019,178,103,11.1356860810811,75
"3237","WI-213138",2020,179,111,12.3406734328358,68
"3238","WI-213138",2021,155,76,8.59794012820513,79
"3239","WI-213138",2022,169,109,12.3724794915254,60
"3240","WI-213138",2023,151,95,10.0410343636364,56
"3241","WI-213186",1979,190,102,11.8768025287356,88
"3242","WI-213186",1980,175,92,11.3789670731707,83
"3243","WI-213186",1981,183,82,10.8340489,101
"3244","WI-213186",1982,186,102,12.684596626506,84
"3245","WI-213186",1983,173,109,10.92346,64
"3246","WI-213186",1984,193,95,11.2945702061856,98
"3247","WI-213186",1985,192,93,13.2669916326531,99
"3248","WI-213186",1986,186,85,12.0310419,101
"3249","WI-213186",1987,149,93,11.5269072727273,56
"3250","WI-213186",1988,150,84,8.86792415384615,66
"3251","WI-213186",1989,172,101,11.1934205714286,71
"3252","WI-213186",1990,179,86,10.9155718478261,93
"3253","WI-213186",1991,133,74,6.5979124137931,59
"3254","WI-213186",1992,NA,105,NA,NA
"3255","WI-213186",1993,186,82,9.79993495145631,104
"3256","WI-213186",1994,165,87,9.30751883116883,78
"3257","WI-213186",1995,167,98,9.7256675,69
"3258","WI-213186",1996,180,105,10.4979198648649,75
"3259","WI-213186",1997,173,102,9.94898542857143,71
"3260","WI-213186",1998,137,82,9.94222759259259,55
"3261","WI-213186",1999,157,84,10.5377706944444,73
"3262","WI-213186",2000,193,77,11.7791899130435,116
"3263","WI-213186",2001,162,88,10.340181369863,74
"3264","WI-213186",2002,173,97,10.5726990666667,76
"3265","WI-213186",2003,174,97,11.5774338157895,77
"3266","WI-213186",2004,194,82,11.1268833333333,112
"3267","WI-213186",2005,156,84,9.75720957746479,72
"3268","WI-213186",2006,147,85,9.34563901639344,62
"3269","WI-213186",2007,152,100,12.6067249019608,52
"3270","WI-213186",2008,190,90,12.0286038383838,100
"3271","WI-213186",2009,170,89,10.013758625,81
"3272","WI-213186",2010,142,64,8.31543805194805,78
"3273","WI-213186",2011,157,89,9.06624462686567,68
"3274","WI-213186",2012,169,68,11.0397795,101
"3275","WI-213186",2013,173,94,10.8114688461538,79
"3276","WI-213186",2014,177,88,11.1117361363636,89
"3277","WI-213186",2015,192,87,12.628785,105
"3278","WI-213186",2016,147,101,10.2144877777778,46
"3279","WI-213186",2017,160,76,9.29547771084337,84
"3280","WI-213186",2018,145,108,11.8481066666667,37
"3281","WI-213186",2019,177,91,10.3693332941176,86
"3282","WI-213186",2020,171,84,9.10216965116279,87
"3283","WI-213186",2021,142,75,8.10452757575758,67
"3284","WI-213186",2022,168,107,12.6310411666667,61
"3285","WI-213186",2023,150,90,10.0646028813559,60
"3286","WI-243021",1979,169,101,12.2884967164179,68
"3287","WI-243021",1980,175,88,12.4385579069767,87
"3288","WI-243021",1981,162,84,9.78053948051948,78
"3289","WI-243021",1982,184,101,13.6022585365854,83
"3290","WI-243021",1983,162,108,10.319810754717,54
"3291","WI-243021",1984,156,92,9.66904793650794,64
"3292","WI-243021",1985,179,82,13.1422198958333,97
"3293","WI-243021",1986,149,83,10.8683958461538,66
"3294","WI-243021",1987,148,92,12.0882385454545,56
"3295","WI-243021",1988,150,81,9.72779764705882,69
"3296","WI-243021",1989,171,81,11.3165266292135,90
"3297","WI-243021",1990,162,85,10.3947044736842,77
"3298","WI-243021",1991,133,74,8.3745824137931,59
"3299","WI-243021",1992,164,84,10.2106964556962,80
"3300","WI-243021",1993,174,81,10.6336034782609,93
"3301","WI-243021",1994,164,76,9.79741252873563,88
"3302","WI-243021",1995,155,97,9.98198175438596,58
"3303","WI-243021",1996,179,98,11.48744975,81
"3304","WI-243021",1997,170,101,11.1007773529412,69
"3305","WI-243021",1998,136,81,10.5134372222222,55
"3306","WI-243021",1999,156,74,10.6277103703704,82
"3307","WI-243021",2000,161,51,9.64289366972477,110
"3308","WI-243021",2001,161,87,11.872817260274,74
"3309","WI-243021",2002,160,94,10.9685149230769,66
"3310","WI-243021",2003,167,97,12.3708963768116,70
"3311","WI-243021",2004,158,79,11.095073974359,79
"3312","WI-243021",2005,155,81,10.6952282191781,74
"3313","WI-243021",2006,146,83,10.1106053225806,63
"3314","WI-243021",2007,150,100,13.3102787755102,50
"3315","WI-243021",2008,157,86,10.0370808571429,71
"3316","WI-243021",2009,168,73,10.0420037234043,95
"3317","WI-243021",2010,142,66,9.35666266666667,76
"3318","WI-243021",2011,153,88,10.15233578125,65
"3319","WI-243021",2012,160,63,12.0632313541667,97
"3320","WI-243021",2013,164,86,10.4355746753247,78
"3321","WI-243021",2014,150,86,9.67619111111111,64
"3322","WI-243021",2015,163,86,12.1509782894737,77
"3323","WI-243021",2016,145,64,7.98445775,81
"3324","WI-243021",2017,160,76,10.9633044578313,84
"3325","WI-243021",2018,145,108,12.936215,37
"3326","WI-243021",2019,176,73,10.6317115686275,103
"3327","WI-243021",2020,146,67,6.74273961538462,79
"3328","WI-243021",2021,140,66,8.50530671232877,74
"3329","WI-243021",2022,131,89,7.40034658536585,42
"3330","WI-243021",2023,150,77,9.47083611111111,73
"3331","WI-243022",1979,169,101,12.2884967164179,68
"3332","WI-243022",1980,175,88,12.4385579069767,87
"3333","WI-243022",1981,162,84,9.78053948051948,78
"3334","WI-243022",1982,184,101,13.6022585365854,83
"3335","WI-243022",1983,162,108,10.319810754717,54
"3336","WI-243022",1984,156,92,9.66904793650794,64
"3337","WI-243022",1985,179,82,13.1422198958333,97
"3338","WI-243022",1986,149,83,10.8683958461538,66
"3339","WI-243022",1987,148,92,12.0882385454545,56
"3340","WI-243022",1988,150,81,9.72779764705882,69
"3341","WI-243022",1989,171,81,11.3165266292135,90
"3342","WI-243022",1990,162,85,10.3947044736842,77
"3343","WI-243022",1991,133,74,8.3745824137931,59
"3344","WI-243022",1992,164,84,10.2106964556962,80
"3345","WI-243022",1993,174,81,10.6336034782609,93
"3346","WI-243022",1994,164,76,9.79741252873563,88
"3347","WI-243022",1995,155,97,9.98198175438596,58
"3348","WI-243022",1996,179,98,11.48744975,81
"3349","WI-243022",1997,170,101,11.1007773529412,69
"3350","WI-243022",1998,136,81,10.5134372222222,55
"3351","WI-243022",1999,156,74,10.6277103703704,82
"3352","WI-243022",2000,161,51,9.64289366972477,110
"3353","WI-243022",2001,161,87,11.872817260274,74
"3354","WI-243022",2002,160,94,10.9685149230769,66
"3355","WI-243022",2003,167,97,12.3708963768116,70
"3356","WI-243022",2004,158,79,11.095073974359,79
"3357","WI-243022",2005,155,81,10.6952282191781,74
"3358","WI-243022",2006,146,83,10.1106053225806,63
"3359","WI-243022",2007,150,100,13.3102787755102,50
"3360","WI-243022",2008,157,86,10.0370808571429,71
"3361","WI-243022",2009,168,73,10.0420037234043,95
"3362","WI-243022",2010,142,66,9.35666266666667,76
"3363","WI-243022",2011,153,88,10.15233578125,65
"3364","WI-243022",2012,160,63,12.0632313541667,97
"3365","WI-243022",2013,164,86,10.4355746753247,78
"3366","WI-243022",2014,150,86,9.67619111111111,64
"3367","WI-243022",2015,163,86,12.1509782894737,77
"3368","WI-243022",2016,145,64,7.98445775,81
"3369","WI-243022",2017,160,76,10.9633044578313,84
"3370","WI-243022",2018,145,108,12.936215,37
"3371","WI-243022",2019,176,73,10.6317115686275,103
"3372","WI-243022",2020,146,67,6.74273961538462,79
"3373","WI-243022",2021,140,66,8.50530671232877,74
"3374","WI-243022",2022,131,89,7.40034658536585,42
"3375","WI-243022",2023,150,77,9.47083611111111,73
"3376","WI-243049",1979,169,101,12.2884967164179,68
"3377","WI-243049",1980,175,88,12.4385579069767,87
"3378","WI-243049",1981,162,84,9.78053948051948,78
"3379","WI-243049",1982,184,101,13.6022585365854,83
"3380","WI-243049",1983,162,108,10.319810754717,54
"3381","WI-243049",1984,156,92,9.66904793650794,64
"3382","WI-243049",1985,179,82,13.1422198958333,97
"3383","WI-243049",1986,149,83,10.8683958461538,66
"3384","WI-243049",1987,148,92,12.0882385454545,56
"3385","WI-243049",1988,150,81,9.72779764705882,69
"3386","WI-243049",1989,171,81,11.3165266292135,90
"3387","WI-243049",1990,162,85,10.3947044736842,77
"3388","WI-243049",1991,133,74,8.3745824137931,59
"3389","WI-243049",1992,164,84,10.2106964556962,80
"3390","WI-243049",1993,174,81,10.6336034782609,93
"3391","WI-243049",1994,164,76,9.79741252873563,88
"3392","WI-243049",1995,155,97,9.98198175438596,58
"3393","WI-243049",1996,179,98,11.48744975,81
"3394","WI-243049",1997,170,101,11.1007773529412,69
"3395","WI-243049",1998,136,81,10.5134372222222,55
"3396","WI-243049",1999,156,74,10.6277103703704,82
"3397","WI-243049",2000,161,51,9.64289366972477,110
"3398","WI-243049",2001,161,87,11.872817260274,74
"3399","WI-243049",2002,160,94,10.9685149230769,66
"3400","WI-243049",2003,167,97,12.3708963768116,70
"3401","WI-243049",2004,158,79,11.095073974359,79
"3402","WI-243049",2005,155,81,10.6952282191781,74
"3403","WI-243049",2006,146,83,10.1106053225806,63
"3404","WI-243049",2007,150,100,13.3102787755102,50
"3405","WI-243049",2008,157,86,10.0370808571429,71
"3406","WI-243049",2009,168,73,10.0420037234043,95
"3407","WI-243049",2010,142,66,9.35666266666667,76
"3408","WI-243049",2011,153,88,10.15233578125,65
"3409","WI-243049",2012,160,63,12.0632313541667,97
"3410","WI-243049",2013,164,86,10.4355746753247,78
"3411","WI-243049",2014,150,86,9.67619111111111,64
"3412","WI-243049",2015,163,86,12.1509782894737,77
"3413","WI-243049",2016,145,64,7.98445775,81
"3414","WI-243049",2017,160,76,10.9633044578313,84
"3415","WI-243049",2018,145,108,12.936215,37
"3416","WI-243049",2019,176,73,10.6317115686275,103
"3417","WI-243049",2020,146,67,6.74273961538462,79
"3418","WI-243049",2021,140,66,8.50530671232877,74
"3419","WI-243049",2022,131,89,7.40034658536585,42
"3420","WI-243049",2023,150,77,9.47083611111111,73
"3421","WI-263056",1979,190,124,9.44703830769231,66
"3422","WI-263056",1980,175,107,10.9519379104478,68
"3423","WI-263056",1981,185,97,10.8105272413793,88
"3424","WI-263056",1982,187,102,12.0194495238095,85
"3425","WI-263056",1983,173,110,10.2862322580645,63
"3426","WI-263056",1984,193,101,11.0820476923077,92
"3427","WI-263056",1985,NA,99,NA,NA
"3428","WI-263056",1986,188,86,11.3826465346535,102
"3429","WI-263056",1987,150,93,11.1044671428571,57
"3430","WI-263056",1988,150,89,8.621971,61
"3431","WI-263056",1989,184,102,11.4527172839506,82
"3432","WI-263056",1990,182,100,11.8683607407407,82
"3433","WI-263056",1991,177,91,12.5519028235294,86
"3434","WI-263056",1992,NA,105,NA,NA
"3435","WI-263056",1993,223,94,12.071902578125,129
"3436","WI-263056",1994,166,96,9.52927594202898,70
"3437","WI-263056",1995,167,99,8.83434059701493,68
"3438","WI-263056",1996,181,106,9.98943594594595,75
"3439","WI-263056",1997,174,104,9.50023768115942,70
"3440","WI-263056",1998,176,82,11.5029579569892,94
"3441","WI-263056",1999,158,86,9.85295478873239,72
"3442","WI-263056",2000,225,78,12.2486180821918,147
"3443","WI-263056",2001,163,89,9.7114401369863,74
"3444","WI-263056",2002,173,97,9.528742,76
"3445","WI-263056",2003,184,98,12.0026769411765,86
"3446","WI-263056",2004,195,93,10.8013508910891,102
"3447","WI-263056",2005,159,85,9.51996301369863,74
"3448","WI-263056",2006,147,86,8.50117516666667,61
"3449","WI-263056",2007,163,101,12.7886521311475,62
"3450","WI-263056",2008,199,103,12.4028904210526,96
"3451","WI-263056",2009,170,99,10.0155901428571,71
"3452","WI-263056",2010,142,86,8.77634581818182,56
"3453","WI-263056",2011,180,108,11.8676670422535,72
"3454","WI-263056",2012,170,69,10.1651256,101
"3455","WI-263056",2013,174,109,11.70137296875,65
"3456","WI-263056",2014,178,107,12.2343052857143,71
"3457","WI-263056",2015,193,88,11.9076761538462,105
"3458","WI-263056",2016,190,102,13.6465120689655,88
"3459","WI-263056",2017,162,83,9.18997538461539,79
"3460","WI-263056",2018,145,109,10.9228385714286,36
"3461","WI-263056",2019,179,103,10.7527321333333,76
"3462","WI-263056",2020,179,110,12.0052345588235,69
"3463","WI-263056",2021,155,77,8.15816207792208,78
"3464","WI-263056",2022,169,109,11.8947255932203,60
"3465","WI-263056",2023,151,97,9.86065377358491,54
"3466","WI-263057",1979,190,104,9.46351635294118,86
"3467","WI-263057",1980,175,106,11.0622533823529,69
"3468","WI-263057",1981,185,94,10.3873823333333,91
"3469","WI-263057",1982,187,102,12.0028944047619,85
"3470","WI-263057",1983,173,109,10.195286031746,64
"3471","WI-263057",1984,193,92,11.1019532,101
"3472","WI-263057",1985,NA,98,NA,NA
"3473","WI-263057",1986,188,86,11.4942643564356,102
"3474","WI-263057",1987,150,93,11.1193946428571,57
"3475","WI-263057",1988,150,89,8.64319466666667,61
"3476","WI-263057",1989,183,102,11.25837325,81
"3477","WI-263057",1990,180,100,11.6208796202532,80
"3478","WI-263057",1991,177,90,12.3709330232558,87
"3479","WI-263057",1992,NA,105,NA,NA
"3480","WI-263057",1993,223,94,12.12024203125,129
"3481","WI-263057",1994,167,96,9.85502442857143,71
"3482","WI-263057",1995,167,100,9.04025666666667,67
"3483","WI-263057",1996,181,106,10.0718891891892,75
"3484","WI-263057",1997,174,104,9.54303695652174,70
"3485","WI-263057",1998,177,82,11.508205106383,95
"3486","WI-263057",1999,158,86,9.75898478873239,72
"3487","WI-263057",2000,225,78,12.2054345205479,147
"3488","WI-263057",2001,176,89,10.7999703488372,87
"3489","WI-263057",2002,173,97,9.51353386666667,76
"3490","WI-263057",2003,183,98,11.9092101190476,85
"3491","WI-263057",2004,194,93,10.7673077,101
"3492","WI-263057",2005,161,85,9.75148893333333,76
"3493","WI-263057",2006,147,86,8.5152375,61
"3494","WI-263057",2007,163,101,12.8493595081967,62
"3495","WI-263057",2008,200,103,12.4666029166667,97
"3496","WI-263057",2009,170,99,10.0682688571429,71
"3497","WI-263057",2010,142,85,8.75860803571429,57
"3498","WI-263057",2011,180,108,11.6483683098592,72
"3499","WI-263057",2012,181,69,11.1083101801802,112
"3500","WI-263057",2013,174,110,11.7081925396825,64
"3501","WI-263057",2014,201,107,13.6484211827957,94
"3502","WI-263057",2015,192,88,11.9160166019417,104
"3503","WI-263057",2016,188,101,13.3683348837209,87
"3504","WI-263057",2017,162,80,8.77289814814815,82
"3505","WI-263057",2018,145,108,10.8170741666667,37
"3506","WI-263057",2019,179,103,10.8176277333333,76
"3507","WI-263057",2020,179,110,12.1428720588235,69
"3508","WI-263057",2021,155,76,7.98746294871795,79
"3509","WI-263057",2022,169,109,11.8791011864407,60
"3510","WI-263057",2023,151,97,9.80508226415094,54
"3511","WI-263059",1979,190,101,10.7526376136364,89
"3512","WI-263059",1980,175,104,12.7049975714286,71
"3513","WI-263059",1981,185,80,10.5223775961538,105
"3514","WI-263059",1982,185,101,11.8527471084337,84
"3515","WI-263059",1983,173,109,10.5038176190476,64
"3516","WI-263059",1984,193,92,11.3326568,101
"3517","WI-263059",1985,218,98,14.3071428571429,120
"3518","WI-263059",1986,187,84,11.6957142156863,103
"3519","WI-263059",1987,150,93,11.3759521428571,57
"3520","WI-263059",1988,150,85,8.39085578125,65
"3521","WI-263059",1989,172,102,10.61545,70
"3522","WI-263059",1990,178,99,11.6649133333333,79
"3523","WI-263059",1991,167,90,12.0907542105263,77
"3524","WI-263059",1992,NA,105,NA,NA
"3525","WI-263059",1993,222,94,12.3669488976378,128
"3526","WI-263059",1994,166,96,9.97356884057971,70
"3527","WI-263059",1995,167,99,9.18018955223881,68
"3528","WI-263059",1996,180,106,10.2512856164384,74
"3529","WI-263059",1997,173,104,9.76161647058824,69
"3530","WI-263059",1998,175,82,11.6360790217391,93
"3531","WI-263059",1999,158,86,10.1165990140845,72
"3532","WI-263059",2000,193,78,10.970483245614,115
"3533","WI-263059",2001,163,89,9.75638876712329,74
"3534","WI-263059",2002,173,97,9.87467933333333,76
"3535","WI-263059",2003,183,98,12.1318660714286,85
"3536","WI-263059",2004,194,93,11.1213702,101
"3537","WI-263059",2005,159,85,9.68316876712329,74
"3538","WI-263059",2006,147,86,8.56992483333333,61
"3539","WI-263059",2007,163,102,13.2586415,61
"3540","WI-263059",2008,191,103,12.1366342528736,88
"3541","WI-263059",2009,169,98,10.1782401428571,71
"3542","WI-263059",2010,142,85,8.74730732142857,57
"3543","WI-263059",2011,179,108,11.910443,71
"3544","WI-263059",2012,170,69,10.4460632,101
"3545","WI-263059",2013,173,108,11.50698421875,65
"3546","WI-263059",2014,177,107,12.6253594202899,70
"3547","WI-263059",2015,192,87,12.0157289423077,105
"3548","WI-263059",2016,169,101,12.2194194029851,68
"3549","WI-263059",2017,161,80,8.975700375,81
"3550","WI-263059",2018,145,109,11.308776,36
"3551","WI-263059",2019,178,103,11.0571387837838,75
"3552","WI-263059",2020,179,109,12.2186797101449,70
"3553","WI-263059",2021,155,76,8.27121717948718,79
"3554","WI-263059",2022,169,109,12.2891910169492,60
"3555","WI-263059",2023,151,97,10.0357716981132,54
"3556","WI-263160",1979,190,104,9.46351635294118,86
"3557","WI-263160",1980,175,106,11.0622533823529,69
"3558","WI-263160",1981,185,94,10.3873823333333,91
"3559","WI-263160",1982,187,102,12.0028944047619,85
"3560","WI-263160",1983,173,109,10.195286031746,64
"3561","WI-263160",1984,193,92,11.1019532,101
"3562","WI-263160",1985,NA,98,NA,NA
"3563","WI-263160",1986,188,86,11.4942643564356,102
"3564","WI-263160",1987,150,93,11.1193946428571,57
"3565","WI-263160",1988,150,89,8.64319466666667,61
"3566","WI-263160",1989,183,102,11.25837325,81
"3567","WI-263160",1990,180,100,11.6208796202532,80
"3568","WI-263160",1991,177,90,12.3709330232558,87
"3569","WI-263160",1992,NA,105,NA,NA
"3570","WI-263160",1993,223,94,12.12024203125,129
"3571","WI-263160",1994,167,96,9.85502442857143,71
"3572","WI-263160",1995,167,100,9.04025666666667,67
"3573","WI-263160",1996,181,106,10.0718891891892,75
"3574","WI-263160",1997,174,104,9.54303695652174,70
"3575","WI-263160",1998,177,82,11.508205106383,95
"3576","WI-263160",1999,158,86,9.75898478873239,72
"3577","WI-263160",2000,225,78,12.2054345205479,147
"3578","WI-263160",2001,176,89,10.7999703488372,87
"3579","WI-263160",2002,173,97,9.51353386666667,76
"3580","WI-263160",2003,183,98,11.9092101190476,85
"3581","WI-263160",2004,194,93,10.7673077,101
"3582","WI-263160",2005,161,85,9.75148893333333,76
"3583","WI-263160",2006,147,86,8.5152375,61
"3584","WI-263160",2007,163,101,12.8493595081967,62
"3585","WI-263160",2008,200,103,12.4666029166667,97
"3586","WI-263160",2009,170,99,10.0682688571429,71
"3587","WI-263160",2010,142,85,8.75860803571429,57
"3588","WI-263160",2011,180,108,11.6483683098592,72
"3589","WI-263160",2012,181,69,11.1083101801802,112
"3590","WI-263160",2013,174,110,11.7081925396825,64
"3591","WI-263160",2014,201,107,13.6484211827957,94
"3592","WI-263160",2015,192,88,11.9160166019417,104
"3593","WI-263160",2016,188,101,13.3683348837209,87
"3594","WI-263160",2017,162,80,8.77289814814815,82
"3595","WI-263160",2018,145,108,10.8170741666667,37
"3596","WI-263160",2019,179,103,10.8176277333333,76
"3597","WI-263160",2020,179,110,12.1428720588235,69
"3598","WI-263160",2021,155,76,7.98746294871795,79
"3599","WI-263160",2022,169,109,11.8791011864407,60
"3600","WI-263160",2023,151,97,9.80508226415094,54
"3601","WI-283122",1979,157,98,11.9100437931034,59
"3602","WI-283122",1980,148,76,9.09850901408451,72
"3603","WI-283122",1981,156,79,11.1033177631579,77
"3604","WI-283122",1982,133,100,11.0531271875,33
"3605","WI-283122",1983,161,88,8.84108513888889,73
"3606","WI-283122",1984,156,87,9.56720735294118,69
"3607","WI-283122",1985,175,67,11.8158294392523,108
"3608","WI-283122",1986,149,81,11.1349629850746,68
"3609","WI-283122",1987,148,92,12.4281527272727,56
"3610","WI-283122",1988,150,80,9.91746217391304,70
"3611","WI-283122",1989,153,81,10.464703943662,72
"3612","WI-283122",1990,115,85,6.09374034482759,30
"3613","WI-283122",1991,132,74,8.86881877192982,58
"3614","WI-283122",1992,164,83,10.470127,81
"3615","WI-283122",1993,162,81,9.920301875,81
"3616","WI-283122",1994,163,70,9.57671554347826,93
"3617","WI-283122",1995,155,69,8.51826552941177,86
"3618","WI-283122",1996,165,98,10.5030568181818,67
"3619","WI-283122",1997,170,101,11.4185627941176,69
"3620","WI-283122",1998,136,81,10.9813190740741,55
"3621","WI-283122",1999,155,74,10.80059725,81
"3622","WI-283122",2000,161,51,10.1304223853211,110
"3623","WI-283122",2001,161,87,12.3460610958904,74
"3624","WI-283122",2002,150,86,9.31871619047619,64
"3625","WI-283122",2003,167,97,12.70774,70
"3626","WI-283122",2004,158,76,11.4778922222222,82
"3627","WI-283122",2005,155,80,10.9518693243243,75
"3628","WI-283122",2006,146,83,10.4946790322581,63
"3629","WI-283122",2007,149,100,13.5959379166667,49
"3630","WI-283122",2008,155,82,9.85679638888889,73
"3631","WI-283122",2009,168,72,10.3256434736842,96
"3632","WI-283122",2010,142,66,9.76666306666667,76
"3633","WI-283122",2011,152,88,10.670129047619,64
"3634","WI-283122",2012,147,63,11.914598313253,84
"3635","WI-283122",2013,163,85,10.806052987013,78
"3636","WI-283122",2014,149,86,10.4922101612903,63
"3637","WI-283122",2015,158,86,12.1768729577465,72
"3638","WI-283122",2016,145,64,8.74803125,81
"3639","WI-283122",2017,160,76,11.5330524096386,84
"3640","WI-283122",2018,144,108,13.147168,36
"3641","WI-283122",2019,175,70,10.9510396153846,105
"3642","WI-283122",2020,145,65,7.11937949367089,80
"3643","WI-283122",2021,140,66,8.98486616438356,74
"3644","WI-283122",2022,130,89,7.54995425,41
"3645","WI-283122",2023,150,76,9.75677602739726,74
"3646","WI-283123",1979,157,98,11.9100437931034,59
"3647","WI-283123",1980,148,76,9.09850901408451,72
"3648","WI-283123",1981,156,79,11.1033177631579,77
"3649","WI-283123",1982,133,100,11.0531271875,33
"3650","WI-283123",1983,161,88,8.84108513888889,73
"3651","WI-283123",1984,156,87,9.56720735294118,69
"3652","WI-283123",1985,175,67,11.8158294392523,108
"3653","WI-283123",1986,149,81,11.1349629850746,68
"3654","WI-283123",1987,148,92,12.4281527272727,56
"3655","WI-283123",1988,150,80,9.91746217391304,70
"3656","WI-283123",1989,153,81,10.464703943662,72
"3657","WI-283123",1990,115,85,6.09374034482759,30
"3658","WI-283123",1991,132,74,8.86881877192982,58
"3659","WI-283123",1992,164,83,10.470127,81
"3660","WI-283123",1993,162,81,9.920301875,81
"3661","WI-283123",1994,163,70,9.57671554347826,93
"3662","WI-283123",1995,155,69,8.51826552941177,86
"3663","WI-283123",1996,165,98,10.5030568181818,67
"3664","WI-283123",1997,170,101,11.4185627941176,69
"3665","WI-283123",1998,136,81,10.9813190740741,55
"3666","WI-283123",1999,155,74,10.80059725,81
"3667","WI-283123",2000,161,51,10.1304223853211,110
"3668","WI-283123",2001,161,87,12.3460610958904,74
"3669","WI-283123",2002,150,86,9.31871619047619,64
"3670","WI-283123",2003,167,97,12.70774,70
"3671","WI-283123",2004,158,76,11.4778922222222,82
"3672","WI-283123",2005,155,80,10.9518693243243,75
"3673","WI-283123",2006,146,83,10.4946790322581,63
"3674","WI-283123",2007,149,100,13.5959379166667,49
"3675","WI-283123",2008,155,82,9.85679638888889,73
"3676","WI-283123",2009,168,72,10.3256434736842,96
"3677","WI-283123",2010,142,66,9.76666306666667,76
"3678","WI-283123",2011,152,88,10.670129047619,64
"3679","WI-283123",2012,147,63,11.914598313253,84
"3680","WI-283123",2013,163,85,10.806052987013,78
"3681","WI-283123",2014,149,86,10.4922101612903,63
"3682","WI-283123",2015,158,86,12.1768729577465,72
"3683","WI-283123",2016,145,64,8.74803125,81
"3684","WI-283123",2017,160,76,11.5330524096386,84
"3685","WI-283123",2018,144,108,13.147168,36
"3686","WI-283123",2019,175,70,10.9510396153846,105
"3687","WI-283123",2020,145,65,7.11937949367089,80
"3688","WI-283123",2021,140,66,8.98486616438356,74
"3689","WI-283123",2022,130,89,7.54995425,41
"3690","WI-283123",2023,150,76,9.75677602739726,74
"3691","WI-303121",1979,156,98,12.0609154385965,58
"3692","WI-303121",1980,151,75,9.26900413333333,76
"3693","WI-303121",1981,155,79,11.0299541333333,76
"3694","WI-303121",1982,133,100,11.4325225,33
"3695","WI-303121",1983,161,87,9.04841054794521,74
"3696","WI-303121",1984,156,82,8.94868123287671,74
"3697","WI-303121",1985,111,66,5.96422113636364,45
"3698","WI-303121",1986,169,80,13.0197065909091,89
"3699","WI-303121",1987,147,74,10.1911848611111,73
"3700","WI-303121",1988,150,79,9.894925,71
"3701","WI-303121",1989,152,80,10.3839471830986,72
"3702","WI-303121",1990,162,66,10.0042390526316,96
"3703","WI-303121",1991,132,73,9.19856517241379,59
"3704","WI-303121",1992,165,82,10.5942313414634,83
"3705","WI-303121",1993,162,80,10.3487756790123,82
"3706","WI-303121",1994,163,70,9.79249391304348,93
"3707","WI-303121",1995,166,68,9.7819624742268,98
"3708","WI-303121",1996,166,89,10.0196363157895,77
"3709","WI-303121",1997,169,101,11.2887597014925,68
"3710","WI-303121",1998,135,79,10.5731067272727,56
"3711","WI-303121",1999,154,75,10.9480033333333,79
"3712","WI-303121",2000,127,51,7.95095573333333,76
"3713","WI-303121",2001,161,87,12.5049875342466,74
"3714","WI-303121",2002,150,86,9.50460333333333,64
"3715","WI-303121",2003,173,97,13.0494525333333,76
"3716","WI-303121",2004,132,75,9.34472928571429,57
"3717","WI-303121",2005,154,79,10.8924910810811,75
"3718","WI-303121",2006,146,82,10.7669326984127,64
"3719","WI-303121",2007,148,99,13.38900625,49
"3720","WI-303121",2008,155,72,9.17067036585366,83
"3721","WI-303121",2009,168,71,10.5642583333333,97
"3722","WI-303121",2010,143,65,9.97658961038961,78
"3723","WI-303121",2011,152,88,11.1176734920635,64
"3724","WI-303121",2012,79,58,7.359545,21
"3725","WI-303121",2013,138,84,8.82097,54
"3726","WI-303121",2014,149,86,11.0263579032258,63
"3727","WI-303121",2015,147,85,11.5056540983607,62
"3728","WI-303121",2016,145,64,9.137094125,81
"3729","WI-303121",2017,160,77,12.112592804878,83
"3730","WI-303121",2018,144,97,10.6914504347826,47
"3731","WI-303121",2019,175,69,11.2405586666667,106
"3732","WI-303121",2020,145,63,7.44776358024691,82
"3733","WI-303121",2021,139,65,9.07830835616438,74
"3734","WI-303121",2022,131,72,7.54513620689655,59
"3735","WI-303121",2023,150,76,10.1032016438356,74
"3736","WI-333254",1979,157,86,10.6512208571429,71
"3737","WI-333254",1980,148,76,9.06241732394366,72
"3738","WI-333254",1981,155,79,11.3851628,76
"3739","WI-333254",1982,134,101,11.199984375,33
"3740","WI-333254",1983,161,88,9.08240458333333,73
"3741","WI-333254",1984,157,89,9.95376507462687,68
"3742","WI-333254",1985,174,80,13.3278317204301,94
"3743","WI-333254",1986,149,81,10.8615262686567,68
"3744","WI-333254",1987,148,73,10.6166694594595,75
"3745","WI-333254",1988,150,79,10.1840991428571,71
"3746","WI-333254",1989,152,80,10.6716890140845,72
"3747","WI-333254",1990,162,66,9.87792347368421,96
"3748","WI-333254",1991,132,75,9.45986785714286,57
"3749","WI-333254",1992,163,81,10.4916440740741,82
"3750","WI-333254",1993,162,81,10.4013565,81
"3751","WI-333254",1994,163,68,9.95074489361702,95
"3752","WI-333254",1995,155,68,8.94347686046512,87
"3753","WI-333254",1996,164,90,10.0309412328767,74
"3754","WI-333254",1997,169,101,11.8321373134328,68
"3755","WI-333254",1998,136,80,11.2857934545455,56
"3756","WI-333254",1999,154,75,11.1127670512821,79
"3757","WI-333254",2000,161,51,10.6293474311927,110
"3758","WI-333254",2001,138,87,12.470201,51
"3759","WI-333254",2002,150,85,9.75426,65
"3760","WI-333254",2003,163,72,10.9995255555556,91
"3761","WI-333254",2004,158,75,11.9857780487805,83
"3762","WI-333254",2005,155,80,11.3451335135135,75
"3763","WI-333254",2006,146,83,10.7313216129032,63
"3764","WI-333254",2007,149,100,14.0218820833333,49
"3765","WI-333254",2008,155,74,9.27563325,81
"3766","WI-333254",2009,167,72,10.8165859574468,95
"3767","WI-333254",2010,142,66,10.0884336,76
"3768","WI-333254",2011,152,88,11.1481793650794,64
"3769","WI-333254",2012,160,62,13.0277718556701,98
"3770","WI-333254",2013,162,85,11.0981856578947,77
"3771","WI-333254",2014,148,85,10.6119540322581,63
"3772","WI-333254",2015,157,86,12.5387121428571,71
"3773","WI-333254",2016,145,64,9.171175875,81
"3774","WI-333254",2017,157,76,12.108481125,81
"3775","WI-333254",2018,144,98,11.376814,46
"3776","WI-333254",2019,157,70,10.2104372093023,87
"3777","WI-333254",2020,145,65,7.65517721518987,80
"3778","WI-333254",2021,141,67,9.2100602739726,74
"3779","WI-333254",2022,130,72,6.81919368421053,58
"3780","WI-333254",2023,150,76,10.0235780821918,74
"3781","WI-343126",1979,190,104,10.5601154117647,86
"3782","WI-343126",1980,175,106,12.1171707352941,69
"3783","WI-343126",1981,185,83,10.5353145544554,102
"3784","WI-343126",1982,185,102,12.1653590243902,83
"3785","WI-343126",1983,173,109,10.4393331746032,64
"3786","WI-343126",1984,193,96,11.5140084375,97
"3787","WI-343126",1985,218,99,14.6470922881356,119
"3788","WI-343126",1986,187,85,11.7806732673267,102
"3789","WI-343126",1987,149,93,11.2058854545455,56
"3790","WI-343126",1988,150,85,8.40220859375,65
"3791","WI-343126",1989,172,102,10.8723565217391,70
"3792","WI-343126",1990,180,99,11.942795,81
"3793","WI-343126",1991,150,90,10.4691598305085,60
"3794","WI-343126",1992,NA,105,NA,NA
"3795","WI-343126",1993,187,94,10.5096084782609,93
"3796","WI-343126",1994,165,94,9.62866971428571,71
"3797","WI-343126",1995,167,98,9.19280941176471,69
"3798","WI-343126",1996,181,106,10.4512174324324,75
"3799","WI-343126",1997,173,104,9.76207632352941,69
"3800","WI-343126",1998,169,82,11.3632091860465,87
"3801","WI-343126",1999,158,85,10.6068779166667,73
"3802","WI-343126",2000,223,78,12.7106988888889,145
"3803","WI-343126",2001,162,89,9.95415805555556,73
"3804","WI-343126",2002,173,97,10.1844702666667,76
"3805","WI-343126",2003,183,98,12.1807873809524,85
"3806","WI-343126",2004,195,93,11.4323064356436,102
"3807","WI-343126",2005,156,84,9.34963901408451,72
"3808","WI-343126",2006,147,85,8.80119737704918,62
"3809","WI-343126",2007,163,101,13.2705937704918,62
"3810","WI-343126",2008,191,91,11.5016032323232,100
"3811","WI-343126",2009,170,90,9.60366202531646,80
"3812","WI-343126",2010,142,66,8.06343426666667,76
"3813","WI-343126",2011,157,90,8.75765121212121,67
"3814","WI-343126",2012,169,68,10.5622791,101
"3815","WI-343126",2013,173,103,11.3377371014493,70
"3816","WI-343126",2014,178,106,12.7587405633803,72
"3817","WI-343126",2015,194,88,12.3698064761905,106
"3818","WI-343126",2016,187,101,13.5752623529412,86
"3819","WI-343126",2017,161,78,8.99562,83
"3820","WI-343126",2018,145,108,11.0768394444444,37
"3821","WI-343126",2019,178,92,10.1344017647059,86
"3822","WI-343126",2020,180,110,12.3825131884058,70
"3823","WI-343126",2021,155,75,8.73246860759494,80
"3824","WI-343126",2022,169,108,12.3826765,61
"3825","WI-343126",2023,151,91,9.76438627118644,60
"3826","WI-343151",1979,190,103,11.1817040697674,87
"3827","WI-343151",1980,175,105,11.9458846376812,70
"3828","WI-343151",1981,185,83,10.6346338613861,102
"3829","WI-343151",1982,186,102,12.3082789156627,84
"3830","WI-343151",1983,173,109,10.5392828571429,64
"3831","WI-343151",1984,194,95,11.5967893877551,99
"3832","WI-343151",1985,218,98,14.6401920168067,120
"3833","WI-343151",1986,187,84,11.9715257843137,103
"3834","WI-343151",1987,149,93,11.2074478181818,56
"3835","WI-343151",1988,150,85,8.49339484375,65
"3836","WI-343151",1989,172,102,11.0398162318841,70
"3837","WI-343151",1990,179,99,11.9557713924051,80
"3838","WI-343151",1991,133,90,7.64900095238095,43
"3839","WI-343151",1992,NA,105,NA,NA
"3840","WI-343151",1993,187,94,10.5706645652174,93
"3841","WI-343151",1994,165,91,9.40597369863014,74
"3842","WI-343151",1995,167,98,9.2931075,69
"3843","WI-343151",1996,180,105,10.3051410810811,75
"3844","WI-343151",1997,173,102,9.59675314285714,71
"3845","WI-343151",1998,169,82,11.3765630232558,87
"3846","WI-343151",1999,158,84,10.5668557534247,74
"3847","WI-343151",2000,194,78,11.4788628695652,116
"3848","WI-343151",2001,162,88,9.85965917808219,74
"3849","WI-343151",2002,173,97,10.3153037333333,76
"3850","WI-343151",2003,174,98,11.4252816,76
"3851","WI-343151",2004,195,82,11.0156303571429,113
"3852","WI-343151",2005,156,84,9.40729718309859,72
"3853","WI-343151",2006,147,85,8.87573557377049,62
"3854","WI-343151",2007,163,100,13.0406851612903,63
"3855","WI-343151",2008,190,91,11.6322360204082,99
"3856","WI-343151",2009,170,90,9.76248329113924,80
"3857","WI-343151",2010,143,65,8.01189792207792,78
"3858","WI-343151",2011,157,90,8.83553878787879,67
"3859","WI-343151",2012,169,68,10.9215763,101
"3860","WI-343151",2013,173,95,10.4235496103896,78
"3861","WI-343151",2014,177,92,11.0602613095238,85
"3862","WI-343151",2015,193,88,12.4131592307692,105
"3863","WI-343151",2016,187,101,13.6259058823529,86
"3864","WI-343151",2017,161,78,9.15101268292683,83
"3865","WI-343151",2018,145,108,11.2471947222222,37
"3866","WI-343151",2019,178,92,10.2898243529412,86
"3867","WI-343151",2020,179,108,12.0746177142857,71
"3868","WI-343151",2021,142,67,6.97225310810811,75
"3869","WI-343151",2022,169,107,12.3527152459016,62
"3870","WI-343151",2023,151,91,9.89799220338983,60
"3871","WI-353089",1979,190,104,11.0479827058824,86
"3872","WI-353089",1980,175,106,11.8390229411765,69
"3873","WI-353089",1981,183,84,10.5919448979592,99
"3874","WI-353089",1982,185,102,12.5598903658537,83
"3875","WI-353089",1983,172,109,10.7612474193548,63
"3876","WI-353089",1984,193,98,12.063164787234,95
"3877","WI-353089",1985,186,98,13.7018464367816,88
"3878","WI-353089",1986,186,84,12.0104447524752,102
"3879","WI-353089",1987,149,93,11.5715103636364,56
"3880","WI-353089",1988,150,84,8.66299707692308,66
"3881","WI-353089",1989,172,101,11.2254527142857,71
"3882","WI-353089",1990,178,99,12.0885919230769,79
"3883","WI-353089",1991,133,90,7.93322738095238,43
"3884","WI-353089",1992,NA,104,NA,NA
"3885","WI-353089",1993,187,94,10.9174716304348,93
"3886","WI-353089",1994,165,93,9.88778281690141,72
"3887","WI-353089",1995,167,98,9.60514823529412,69
"3888","WI-353089",1996,180,105,10.6533256756757,75
"3889","WI-353089",1997,172,103,9.97097411764706,69
"3890","WI-353089",1998,168,81,11.4319836046512,87
"3891","WI-353089",1999,157,84,10.64562625,73
"3892","WI-353089",2000,189,77,11.3307145045045,112
"3893","WI-353089",2001,162,89,10.0903341666667,73
"3894","WI-353089",2002,172,97,10.5370824324324,75
"3895","WI-353089",2003,183,98,12.552345952381,85
"3896","WI-353089",2004,194,82,11.1514462162162,112
"3897","WI-353089",2005,156,84,9.60866197183099,72
"3898","WI-353089",2006,146,86,8.90544050847458,60
"3899","WI-353089",2007,163,101,13.3437245901639,62
"3900","WI-353089",2008,190,91,11.5694167346939,99
"3901","WI-353089",2009,169,90,9.78564141025641,79
"3902","WI-353089",2010,142,65,8.15505618421053,77
"3903","WI-353089",2011,156,90,8.93648061538462,66
"3904","WI-353089",2012,169,68,11.150561,101
"3905","WI-353089",2013,173,104,11.6902832352941,69
"3906","WI-353089",2014,170,106,12.288423015873,64
"3907","WI-353089",2015,192,87,12.4808732692308,105
"3908","WI-353089",2016,169,100,12.6431448529412,69
"3909","WI-353089",2017,160,77,9.19624365853659,83
"3910","WI-353089",2018,145,108,11.4761452777778,37
"3911","WI-353089",2019,177,92,10.4843797619048,85
"3912","WI-353089",2020,179,109,12.6006989855072,70
"3913","WI-353089",2021,142,67,7.11762945945946,75
"3914","WI-353089",2022,168,107,12.428827,61
"3915","WI-353089",2023,151,91,9.94685372881356,60
"3916","WI-363036",1979,191,99,10.3035975824176,92
"3917","WI-363036",1980,193,85,10.3001537383178,108
"3918","WI-363036",1981,187,79,9.08270037383178,108
"3919","WI-363036",1982,197,100,11.6929410416667,97
"3920","WI-363036",1983,193,108,10.9703551190476,85
"3921","WI-363036",1984,195,85,9.50057788990826,110
"3922","WI-363036",1985,192,78,9.60318796460177,114
"3923","WI-363036",1986,197,83,10.7758995575221,114
"3924","WI-363036",1987,166,93,10.0760009722222,73
"3925","WI-363036",1988,187,83,9.75240825242718,104
"3926","WI-363036",1989,186,83,9.22283892156863,103
"3927","WI-363036",1990,237,86,12.4311960666667,151
"3928","WI-363036",1991,186,74,10.4096105405405,112
"3929","WI-363036",1992,NA,84,NA,NA
"3930","WI-363036",1993,223,80,11.0383268309859,143
"3931","WI-363036",1994,169,78,7.10174722222222,91
"3932","WI-363036",1995,171,97,8.7353097260274,74
"3933","WI-363036",1996,219,99,11.5015019327731,120
"3934","WI-363036",1997,175,101,8.65471,74
"3935","WI-363036",1998,197,81,11.3429312173913,116
"3936","WI-363036",1999,161,73,7.64484666666667,88
"3937","WI-363036",2000,222,74,10.9117004081633,148
"3938","WI-363036",2001,198,87,10.6435473636364,111
"3939","WI-363036",2002,174,88,7.675562,86
"3940","WI-363036",2003,184,98,10.0045152941176,86
"3941","WI-363036",2004,212,79,10.7092116666667,133
"3942","WI-363036",2005,177,79,9.56809195876289,98
"3943","WI-363036",2006,186,80,11.1880046666667,106
"3944","WI-363036",2007,165,98,10.5044681818182,67
"3945","WI-363036",2008,199,73,9.60125816,126
"3946","WI-363036",2009,173,73,7.53469888888889,100
"3947","WI-363036",2010,186,63,10.0786166393443,123
"3948","WI-363036",2011,185,88,9.833861875,97
"3949","WI-363036",2012,181,46,8.46669044776119,135
"3950","WI-363036",2013,176,83,8.56153815217391,93
"3951","WI-363036",2014,219,88,11.9279323846154,131
"3952","WI-363036",2015,197,85,10.7894386486486,112
"3953","WI-363036",2016,189,65,9.98587601626016,124
"3954","WI-363036",2017,199,75,10.9592714634146,124
"3955","WI-363036",2018,149,98,8.5497398,51
"3956","WI-363036",2019,180,73,7.8804029245283,107
"3957","WI-363036",2020,180,63,7.98701543103448,117
"3958","WI-363036",2021,162,64,7.59066268041237,98
"3959","WI-363036",2022,199,89,11.5797414678899,110
"3960","WI-363036",2023,152,76,7.12097333333333,76
"3961","WI-363064",1979,190,101,12.4296622727273,89
"3962","WI-363064",1980,175,88,11.420843372093,87
"3963","WI-363064",1981,164,84,8.82959430379747,80
"3964","WI-363064",1982,185,102,13.1046686585366,83
"3965","WI-363064",1983,163,110,9.64631980769231,53
"3966","WI-363064",1984,157,92,9.0834459375,65
"3967","WI-363064",1985,184,82,12.3970771287129,102
"3968","WI-363064",1986,176,83,12.1814779347826,93
"3969","WI-363064",1987,148,92,11.0341192727273,56
"3970","WI-363064",1988,150,81,8.84027485294118,69
"3971","WI-363064",1989,172,82,10.4153250561798,90
"3972","WI-363064",1990,165,85,10.0968921518987,80
"3973","WI-363064",1991,133,74,7.63306879310345,59
"3974","WI-363064",1992,220,84,12.6069546666667,136
"3975","WI-363064",1993,185,81,10.5618095145631,104
"3976","WI-363064",1994,164,78,9.09030635294118,86
"3977","WI-363064",1995,166,97,10.3484132352941,69
"3978","WI-363064",1996,179,99,10.659036835443,80
"3979","WI-363064",1997,172,101,10.3721851428571,71
"3980","WI-363064",1998,136,81,9.63568907407407,55
"3981","WI-363064",1999,157,74,9.94919256097561,83
"3982","WI-363064",2000,174,52,9.85235603305785,122
"3983","WI-363064",2001,162,87,10.976792972973,75
"3984","WI-363064",2002,171,94,10.9284298684211,77
"3985","WI-363064",2003,174,98,11.9895529333333,76
"3986","WI-363064",2004,194,80,12.2583504424779,114
"3987","WI-363064",2005,155,82,9.9787325,73
"3988","WI-363064",2006,147,83,9.74973968253968,64
"3989","WI-363064",2007,151,100,12.5123466,51
"3990","WI-363064",2008,159,87,9.76316070422535,72
"3991","WI-363064",2009,170,73,9.33182708333333,97
"3992","WI-363064",2010,144,66,8.78413688311688,78
"3993","WI-363064",2011,156,88,9.67507671641791,68
"3994","WI-363064",2012,168,63,11.6342460576923,105
"3995","WI-363064",2013,173,85,10.4178489655172,88
"3996","WI-363064",2014,177,87,11.7852061797753,90
"3997","WI-363064",2015,174,86,12.1831079310345,88
"3998","WI-363064",2016,146,97,9.43763208333333,49
"3999","WI-363064",2017,161,77,10.3289680722892,84
"4000","WI-363064",2018,145,108,12.0182444444444,37
"4001","WI-363064",2019,176,73,9.54722941176471,103
"4002","WI-363064",2020,146,68,5.86231285714286,78
"4003","WI-363064",2021,140,66,7.81234904109589,74
"4004","WI-363064",2022,132,90,7.06192048780488,42
"4005","WI-363064",2023,150,77,8.94175652777778,73
"4006","WI-363310",1979,190,101,12.4296622727273,89
"4007","WI-363310",1980,175,88,11.420843372093,87
"4008","WI-363310",1981,164,84,8.82959430379747,80
"4009","WI-363310",1982,185,102,13.1046686585366,83
"4010","WI-363310",1983,163,110,9.64631980769231,53
"4011","WI-363310",1984,157,92,9.0834459375,65
"4012","WI-363310",1985,184,82,12.3970771287129,102
"4013","WI-363310",1986,176,83,12.1814779347826,93
"4014","WI-363310",1987,148,92,11.0341192727273,56
"4015","WI-363310",1988,150,81,8.84027485294118,69
"4016","WI-363310",1989,172,82,10.4153250561798,90
"4017","WI-363310",1990,165,85,10.0968921518987,80
"4018","WI-363310",1991,133,74,7.63306879310345,59
"4019","WI-363310",1992,220,84,12.6069546666667,136
"4020","WI-363310",1993,185,81,10.5618095145631,104
"4021","WI-363310",1994,164,78,9.09030635294118,86
"4022","WI-363310",1995,166,97,10.3484132352941,69
"4023","WI-363310",1996,179,99,10.659036835443,80
"4024","WI-363310",1997,172,101,10.3721851428571,71
"4025","WI-363310",1998,136,81,9.63568907407407,55
"4026","WI-363310",1999,157,74,9.94919256097561,83
"4027","WI-363310",2000,174,52,9.85235603305785,122
"4028","WI-363310",2001,162,87,10.976792972973,75
"4029","WI-363310",2002,171,94,10.9284298684211,77
"4030","WI-363310",2003,174,98,11.9895529333333,76
"4031","WI-363310",2004,194,80,12.2583504424779,114
"4032","WI-363310",2005,155,82,9.9787325,73
"4033","WI-363310",2006,147,83,9.74973968253968,64
"4034","WI-363310",2007,151,100,12.5123466,51
"4035","WI-363310",2008,159,87,9.76316070422535,72
"4036","WI-363310",2009,170,73,9.33182708333333,97
"4037","WI-363310",2010,144,66,8.78413688311688,78
"4038","WI-363310",2011,156,88,9.67507671641791,68
"4039","WI-363310",2012,168,63,11.6342460576923,105
"4040","WI-363310",2013,173,85,10.4178489655172,88
"4041","WI-363310",2014,177,87,11.7852061797753,90
"4042","WI-363310",2015,174,86,12.1831079310345,88
"4043","WI-363310",2016,146,97,9.43763208333333,49
"4044","WI-363310",2017,161,77,10.3289680722892,84
"4045","WI-363310",2018,145,108,12.0182444444444,37
"4046","WI-363310",2019,176,73,9.54722941176471,103
"4047","WI-363310",2020,146,68,5.86231285714286,78
"4048","WI-363310",2021,140,66,7.81234904109589,74
"4049","WI-363310",2022,132,90,7.06192048780488,42
"4050","WI-363310",2023,150,77,8.94175652777778,73
"4051","WI-373390",1979,189,100,12.7663017045455,89
"4052","WI-373390",1980,175,87,11.5790273563218,88
"4053","WI-373390",1981,182,80,11.7061756435644,102
"4054","WI-373390",1982,184,101,13.1243624390244,83
"4055","WI-373390",1983,163,108,10.2172161111111,55
"4056","WI-373390",1984,193,87,11.9254291428571,106
"4057","WI-373390",1985,180,77,11.651722254902,103
"4058","WI-373390",1986,185,83,12.7875305940594,102
"4059","WI-373390",1987,149,92,11.8978308928571,57
"4060","WI-373390",1988,150,83,9.18839439393939,67
"4061","WI-373390",1989,171,100,11.7331025714286,71
"4062","WI-373390",1990,166,86,10.2770089873418,80
"4063","WI-373390",1991,133,75,7.21098263157895,58
"4064","WI-373390",1992,234,85,13.0669018918919,149
"4065","WI-373390",1993,186,81,10.50466375,105
"4066","WI-373390",1994,164,86,9.83051844155844,78
"4067","WI-373390",1995,167,97,10.3889104347826,70
"4068","WI-373390",1996,179,102,10.8209644736842,77
"4069","WI-373390",1997,172,101,10.5235241428571,71
"4070","WI-373390",1998,136,81,10.0821583333333,55
"4071","WI-373390",1999,157,75,10.182472345679,82
"4072","WI-373390",2000,185,52,10.4118458333333,133
"4073","WI-373390",2001,162,88,10.8965819178082,74
"4074","WI-373390",2002,161,96,10.1328321875,65
"4075","WI-373390",2003,173,97,12.1952858666667,76
"4076","WI-373390",2004,193,81,11.9963022522523,112
"4077","WI-373390",2005,155,83,10.0354107042254,72
"4078","WI-373390",2006,146,84,9.3996606557377,62
"4079","WI-373390",2007,152,100,12.8368115686275,52
"4080","WI-373390",2008,187,87,11.8357446464646,100
"4081","WI-373390",2009,169,74,9.16572882978723,95
"4082","WI-373390",2010,143,65,8.69148454545455,78
"4083","WI-373390",2011,156,89,9.56036939393939,67
"4084","WI-373390",2012,168,67,12.0279439,101
"4085","WI-373390",2013,173,94,11.2460643589744,79
"4086","WI-373390",2014,170,88,10.8626744444444,82
"4087","WI-373390",2015,191,86,13.0302855769231,105
"4088","WI-373390",2016,146,98,10.04649,48
"4089","WI-373390",2017,160,76,9.95285638554217,84
"4090","WI-373390",2018,145,108,12.1527938888889,37
"4091","WI-373390",2019,177,82,10.3559137234043,95
"4092","WI-373390",2020,171,81,9.67225808988764,90
"4093","WI-373390",2021,141,66,7.63493540540541,75
"4094","WI-373390",2022,131,90,5.93785625,41
"4095","WI-373390",2023,150,89,10.2546953333333,61
"4096","WI-373416",1979,189,100,12.7663017045455,89
"4097","WI-373416",1980,175,87,11.5790273563218,88
"4098","WI-373416",1981,182,80,11.7061756435644,102
"4099","WI-373416",1982,184,101,13.1243624390244,83
"4100","WI-373416",1983,163,108,10.2172161111111,55
"4101","WI-373416",1984,193,87,11.9254291428571,106
"4102","WI-373416",1985,180,77,11.651722254902,103
"4103","WI-373416",1986,185,83,12.7875305940594,102
"4104","WI-373416",1987,149,92,11.8978308928571,57
"4105","WI-373416",1988,150,83,9.18839439393939,67
"4106","WI-373416",1989,171,100,11.7331025714286,71
"4107","WI-373416",1990,166,86,10.2770089873418,80
"4108","WI-373416",1991,133,75,7.21098263157895,58
"4109","WI-373416",1992,234,85,13.0669018918919,149
"4110","WI-373416",1993,186,81,10.50466375,105
"4111","WI-373416",1994,164,86,9.83051844155844,78
"4112","WI-373416",1995,167,97,10.3889104347826,70
"4113","WI-373416",1996,179,102,10.8209644736842,77
"4114","WI-373416",1997,172,101,10.5235241428571,71
"4115","WI-373416",1998,136,81,10.0821583333333,55
"4116","WI-373416",1999,157,75,10.182472345679,82
"4117","WI-373416",2000,185,52,10.4118458333333,133
"4118","WI-373416",2001,162,88,10.8965819178082,74
"4119","WI-373416",2002,161,96,10.1328321875,65
"4120","WI-373416",2003,173,97,12.1952858666667,76
"4121","WI-373416",2004,193,81,11.9963022522523,112
"4122","WI-373416",2005,155,83,10.0354107042254,72
"4123","WI-373416",2006,146,84,9.3996606557377,62
"4124","WI-373416",2007,152,100,12.8368115686275,52
"4125","WI-373416",2008,187,87,11.8357446464646,100
"4126","WI-373416",2009,169,74,9.16572882978723,95
"4127","WI-373416",2010,143,65,8.69148454545455,78
"4128","WI-373416",2011,156,89,9.56036939393939,67
"4129","WI-373416",2012,168,67,12.0279439,101
"4130","WI-373416",2013,173,94,11.2460643589744,79
"4131","WI-373416",2014,170,88,10.8626744444444,82
"4132","WI-373416",2015,191,86,13.0302855769231,105
"4133","WI-373416",2016,146,98,10.04649,48
"4134","WI-373416",2017,160,76,9.95285638554217,84
"4135","WI-373416",2018,145,108,12.1527938888889,37
"4136","WI-373416",2019,177,82,10.3559137234043,95
"4137","WI-373416",2020,171,81,9.67225808988764,90
"4138","WI-373416",2021,141,66,7.63493540540541,75
"4139","WI-373416",2022,131,90,5.93785625,41
"4140","WI-373416",2023,150,89,10.2546953333333,61
"4141","WI-383095",1979,190,103,10.4317044186047,87
"4142","WI-383095",1980,175,104,12.459239,71
"4143","WI-383095",1981,183,84,10.9398406122449,99
"4144","WI-383095",1982,186,102,12.713681686747,84
"4145","WI-383095",1983,173,110,10.790265,63
"4146","WI-383095",1984,193,91,11.8093113861386,102
"4147","WI-383095",1985,192,82,11.9557951376147,110
"4148","WI-383095",1986,186,86,11.9966117171717,100
"4149","WI-383095",1987,149,93,11.0690954545455,56
"4150","WI-383095",1988,150,85,8.667955,65
"4151","WI-383095",1989,173,100,10.9316981944444,73
"4152","WI-383095",1990,179,86,10.8385502173913,93
"4153","WI-383095",1991,150,74,8.88155826666667,76
"4154","WI-383095",1992,235,104,13.9104255384615,131
"4155","WI-383095",1993,186,82,9.80046533980583,104
"4156","WI-383095",1994,165,87,9.10094376623377,78
"4157","WI-383095",1995,167,98,9.73095161764706,69
"4158","WI-383095",1996,179,106,10.3185263888889,73
"4159","WI-383095",1997,173,102,9.90557057142857,71
"4160","WI-383095",1998,168,82,11.4185472941176,86
"4161","WI-383095",1999,158,84,10.3871680821918,74
"4162","WI-383095",2000,193,76,11.6092924137931,117
"4163","WI-383095",2001,162,88,10.279394109589,74
"4164","WI-383095",2002,173,97,10.4256157333333,76
"4165","WI-383095",2003,174,98,11.5185108,76
"4166","WI-383095",2004,194,82,10.9956187387387,112
"4167","WI-383095",2005,156,84,9.46781732394366,72
"4168","WI-383095",2006,147,84,9.08501612903226,63
"4169","WI-383095",2007,151,100,12.1232834,51
"4170","WI-383095",2008,180,90,11.2759743820225,90
"4171","WI-383095",2009,171,74,8.575280625,97
"4172","WI-383095",2010,143,65,8.19128116883117,78
"4173","WI-383095",2011,180,89,11.1314444444444,91
"4174","WI-383095",2012,169,68,10.8423569,101
"4175","WI-383095",2013,173,93,10.6974994936709,80
"4176","WI-383095",2014,178,88,11.0091115730337,90
"4177","WI-383095",2015,192,88,12.5610405825243,104
"4178","WI-383095",2016,147,101,9.95528511111111,46
"4179","WI-383095",2017,161,76,9.38693630952381,85
"4180","WI-383095",2018,145,108,11.5091311111111,37
"4181","WI-383095",2019,177,88,9.88849102272727,89
"4182","WI-383095",2020,171,85,9.17745105882353,86
"4183","WI-383095",2021,142,69,7.43822236111111,73
"4184","WI-383095",2022,169,92,10.6788460526316,77
"4185","WI-383095",2023,151,89,10.0158914754098,62
"4186","WI-383185",1979,190,103,10.4317044186047,87
"4187","WI-383185",1980,175,104,12.459239,71
"4188","WI-383185",1981,183,84,10.9398406122449,99
"4189","WI-383185",1982,186,102,12.713681686747,84
"4190","WI-383185",1983,173,110,10.790265,63
"4191","WI-383185",1984,193,91,11.8093113861386,102
"4192","WI-383185",1985,192,82,11.9557951376147,110
"4193","WI-383185",1986,186,86,11.9966117171717,100
"4194","WI-383185",1987,149,93,11.0690954545455,56
"4195","WI-383185",1988,150,85,8.667955,65
"4196","WI-383185",1989,173,100,10.9316981944444,73
"4197","WI-383185",1990,179,86,10.8385502173913,93
"4198","WI-383185",1991,150,74,8.88155826666667,76
"4199","WI-383185",1992,235,104,13.9104255384615,131
"4200","WI-383185",1993,186,82,9.80046533980583,104
"4201","WI-383185",1994,165,87,9.10094376623377,78
"4202","WI-383185",1995,167,98,9.73095161764706,69
"4203","WI-383185",1996,179,106,10.3185263888889,73
"4204","WI-383185",1997,173,102,9.90557057142857,71
"4205","WI-383185",1998,168,82,11.4185472941176,86
"4206","WI-383185",1999,158,84,10.3871680821918,74
"4207","WI-383185",2000,193,76,11.6092924137931,117
"4208","WI-383185",2001,162,88,10.279394109589,74
"4209","WI-383185",2002,173,97,10.4256157333333,76
"4210","WI-383185",2003,174,98,11.5185108,76
"4211","WI-383185",2004,194,82,10.9956187387387,112
"4212","WI-383185",2005,156,84,9.46781732394366,72
"4213","WI-383185",2006,147,84,9.08501612903226,63
"4214","WI-383185",2007,151,100,12.1232834,51
"4215","WI-383185",2008,180,90,11.2759743820225,90
"4216","WI-383185",2009,171,74,8.575280625,97
"4217","WI-383185",2010,143,65,8.19128116883117,78
"4218","WI-383185",2011,180,89,11.1314444444444,91
"4219","WI-383185",2012,169,68,10.8423569,101
"4220","WI-383185",2013,173,93,10.6974994936709,80
"4221","WI-383185",2014,178,88,11.0091115730337,90
"4222","WI-383185",2015,192,88,12.5610405825243,104
"4223","WI-383185",2016,147,101,9.95528511111111,46
"4224","WI-383185",2017,161,76,9.38693630952381,85
"4225","WI-383185",2018,145,108,11.5091311111111,37
"4226","WI-383185",2019,177,88,9.88849102272727,89
"4227","WI-383185",2020,171,85,9.17745105882353,86
"4228","WI-383185",2021,142,69,7.43822236111111,73
"4229","WI-383185",2022,169,92,10.6788460526316,77
"4230","WI-383185",2023,151,89,10.0158914754098,62
"4231","WI-393017",1979,169,99,12.6831497101449,70
"4232","WI-393017",1980,148,84,9.74720920634921,64
"4233","WI-393017",1981,162,79,11.0598326829268,83
"4234","WI-393017",1982,182,101,13.8849675,81
"4235","WI-393017",1983,162,88,8.53175493150685,74
"4236","WI-393017",1984,157,88,9.56068941176471,69
"4237","WI-393017",1985,175,68,11.4638290566038,107
"4238","WI-393017",1986,149,81,10.8347067164179,68
"4239","WI-393017",1987,148,92,12.3977550909091,56
"4240","WI-393017",1988,150,81,9.75445235294118,69
"4241","WI-393017",1989,171,82,11.5016056818182,89
"4242","WI-393017",1990,162,85,10.4954442105263,77
"4243","WI-393017",1991,133,74,8.24459948275862,59
"4244","WI-393017",1992,163,85,10.2047724675325,78
"4245","WI-393017",1993,184,81,11.3365433333333,103
"4246","WI-393017",1994,164,76,9.92681252873563,88
"4247","WI-393017",1995,155,97,10.0051445614035,58
"4248","WI-393017",1996,165,99,10.1325144615385,66
"4249","WI-393017",1997,170,101,11.2663336764706,69
"4250","WI-393017",1998,136,81,10.7078822222222,55
"4251","WI-393017",1999,155,75,10.7016688607595,80
"4252","WI-393017",2000,161,51,9.54706486238532,110
"4253","WI-393017",2001,161,87,11.722452739726,74
"4254","WI-393017",2002,160,94,10.8339,66
"4255","WI-393017",2003,166,97,12.4487336764706,69
"4256","WI-393017",2004,158,80,11.1619551948052,78
"4257","WI-393017",2005,155,82,10.7516275,73
"4258","WI-393017",2006,146,84,10.0240198360656,62
"4259","WI-393017",2007,151,100,13.6487524,51
"4260","WI-393017",2008,157,84,9.74209944444444,73
"4261","WI-393017",2009,168,73,10.0026920212766,95
"4262","WI-393017",2010,142,66,9.2932256,76
"4263","WI-393017",2011,153,88,10.08788296875,65
"4264","WI-393017",2012,160,66,12.4984891397849,94
"4265","WI-393017",2013,164,90,10.7708647945205,74
"4266","WI-393017",2014,149,86,9.27761838709677,63
"4267","WI-393017",2015,167,86,12.4198805,81
"4268","WI-393017",2016,145,64,8.06834425,81
"4269","WI-393017",2017,159,76,10.874533902439,83
"4270","WI-393017",2018,144,108,12.8317668571429,36
"4271","WI-393017",2019,175,78,11.095356875,97
"4272","WI-393017",2020,146,67,6.67853730769231,79
"4273","WI-393017",2021,140,66,8.38330328767123,74
"4274","WI-393017",2022,131,89,7.22008780487805,42
"4275","WI-393017",2023,150,77,9.36449902777778,73
"4276","WI-393018",1979,169,99,12.6831497101449,70
"4277","WI-393018",1980,148,84,9.74720920634921,64
"4278","WI-393018",1981,162,79,11.0598326829268,83
"4279","WI-393018",1982,182,101,13.8849675,81
"4280","WI-393018",1983,162,88,8.53175493150685,74
"4281","WI-393018",1984,157,88,9.56068941176471,69
"4282","WI-393018",1985,175,68,11.4638290566038,107
"4283","WI-393018",1986,149,81,10.8347067164179,68
"4284","WI-393018",1987,148,92,12.3977550909091,56
"4285","WI-393018",1988,150,81,9.75445235294118,69
"4286","WI-393018",1989,171,82,11.5016056818182,89
"4287","WI-393018",1990,162,85,10.4954442105263,77
"4288","WI-393018",1991,133,74,8.24459948275862,59
"4289","WI-393018",1992,163,85,10.2047724675325,78
"4290","WI-393018",1993,184,81,11.3365433333333,103
"4291","WI-393018",1994,164,76,9.92681252873563,88
"4292","WI-393018",1995,155,97,10.0051445614035,58
"4293","WI-393018",1996,165,99,10.1325144615385,66
"4294","WI-393018",1997,170,101,11.2663336764706,69
"4295","WI-393018",1998,136,81,10.7078822222222,55
"4296","WI-393018",1999,155,75,10.7016688607595,80
"4297","WI-393018",2000,161,51,9.54706486238532,110
"4298","WI-393018",2001,161,87,11.722452739726,74
"4299","WI-393018",2002,160,94,10.8339,66
"4300","WI-393018",2003,166,97,12.4487336764706,69
"4301","WI-393018",2004,158,80,11.1619551948052,78
"4302","WI-393018",2005,155,82,10.7516275,73
"4303","WI-393018",2006,146,84,10.0240198360656,62
"4304","WI-393018",2007,151,100,13.6487524,51
"4305","WI-393018",2008,157,84,9.74209944444444,73
"4306","WI-393018",2009,168,73,10.0026920212766,95
"4307","WI-393018",2010,142,66,9.2932256,76
"4308","WI-393018",2011,153,88,10.08788296875,65
"4309","WI-393018",2012,160,66,12.4984891397849,94
"4310","WI-393018",2013,164,90,10.7708647945205,74
"4311","WI-393018",2014,149,86,9.27761838709677,63
"4312","WI-393018",2015,167,86,12.4198805,81
"4313","WI-393018",2016,145,64,8.06834425,81
"4314","WI-393018",2017,159,76,10.874533902439,83
"4315","WI-393018",2018,144,108,12.8317668571429,36
"4316","WI-393018",2019,175,78,11.095356875,97
"4317","WI-393018",2020,146,67,6.67853730769231,79
"4318","WI-393018",2021,140,66,8.38330328767123,74
"4319","WI-393018",2022,131,89,7.22008780487805,42
"4320","WI-393018",2023,150,77,9.36449902777778,73
"4321","WI-403110",1979,190,103,11.9575036046512,87
"4322","WI-403110",1980,175,91,11.3938645783133,84
"4323","WI-403110",1981,164,81,9.53333890243903,83
"4324","WI-403110",1982,185,102,13.0274015853659,83
"4325","WI-403110",1983,172,108,10.9645976190476,64
"4326","WI-403110",1984,193,92,12.2164845,101
"4327","WI-403110",1985,186,82,12.1343447572816,104
"4328","WI-403110",1986,176,84,11.8963973626374,92
"4329","WI-403110",1987,149,92,11.3303073214286,57
"4330","WI-403110",1988,150,83,8.95780772727273,67
"4331","WI-403110",1989,172,83,10.0007609090909,89
"4332","WI-403110",1990,166,86,10.1315378481013,80
"4333","WI-403110",1991,133,74,7.03500862068966,59
"4334","WI-403110",1992,235,85,12.924302147651,150
"4335","WI-403110",1993,186,81,10.3614845192308,105
"4336","WI-403110",1994,164,87,9.59763394736842,77
"4337","WI-403110",1995,167,97,10.2932353623188,70
"4338","WI-403110",1996,179,102,10.5469113157895,77
"4339","WI-403110",1997,172,102,10.34,70
"4340","WI-403110",1998,167,82,11.8334222619048,85
"4341","WI-403110",1999,157,83,10.7544993150685,74
"4342","WI-403110",2000,193,53,10.9139403597122,140
"4343","WI-403110",2001,162,88,10.8487424657534,74
"4344","WI-403110",2002,172,95,10.9068330263158,77
"4345","WI-403110",2003,174,97,11.9698067105263,77
"4346","WI-403110",2004,193,82,11.8787905454545,111
"4347","WI-403110",2005,155,83,9.83514633802817,72
"4348","WI-403110",2006,147,83,9.39805317460318,64
"4349","WI-403110",2007,151,99,12.3087460784314,52
"4350","WI-403110",2008,177,86,11.0420034444444,91
"4351","WI-403110",2009,169,74,9.08585819148936,95
"4352","WI-403110",2010,143,65,8.56851376623377,78
"4353","WI-403110",2011,156,89,9.39015121212121,67
"4354","WI-403110",2012,168,67,11.9383352,101
"4355","WI-403110",2013,173,93,11.132132278481,80
"4356","WI-403110",2014,176,88,11.4651802298851,88
"4357","WI-403110",2015,189,87,13.003704950495,102
"4358","WI-403110",2016,146,98,9.54100489361702,48
"4359","WI-403110",2017,160,76,9.85345867469879,84
"4360","WI-403110",2018,145,108,11.9568308333333,37
"4361","WI-403110",2019,177,82,10.0439115957447,95
"4362","WI-403110",2020,172,84,9.79997321839081,88
"4363","WI-403110",2021,142,67,7.82043824324324,75
"4364","WI-403110",2022,132,90,6.19358951219512,42
"4365","WI-403110",2023,151,81,9.19742869565217,70
"4366","WI-423126",1979,168,99,12.5434139705882,69
"4367","WI-423126",1980,147,85,9.72783,62
"4368","WI-423126",1981,163,78,11.2752253571429,85
"4369","WI-423126",1982,182,100,13.8416280246914,82
"4370","WI-423126",1983,162,108,10.9322809433962,54
"4371","WI-423126",1984,157,85,8.98500732394366,72
"4372","WI-423126",1985,175,68,11.4332423584906,107
"4373","WI-423126",1986,149,81,10.9145813432836,68
"4374","WI-423126",1987,149,92,12.6767083928571,57
"4375","WI-423126",1988,150,81,9.88278308823529,69
"4376","WI-423126",1989,170,81,11.2608020454545,89
"4377","WI-423126",1990,162,85,10.2642563157895,77
"4378","WI-423126",1991,133,74,8.08969603448276,59
"4379","WI-423126",1992,163,84,9.97387935897436,79
"4380","WI-423126",1993,184,81,11.254588627451,103
"4381","WI-423126",1994,164,72,9.42554725274725,92
"4382","WI-423126",1995,155,97,9.63206298245614,58
"4383","WI-423126",1996,165,98,9.98009333333333,67
"4384","WI-423126",1997,170,101,11.1261682352941,69
"4385","WI-423126",1998,136,81,10.6446588888889,55
"4386","WI-423126",1999,156,74,10.358902345679,82
"4387","WI-423126",2000,162,51,9.45771290909091,111
"4388","WI-423126",2001,161,88,11.48872375,73
"4389","WI-423126",2002,160,94,10.6245246153846,66
"4390","WI-423126",2003,166,97,12.2398638235294,69
"4391","WI-423126",2004,158,79,10.9676703846154,79
"4392","WI-423126",2005,155,83,10.8330556338028,72
"4393","WI-423126",2006,146,84,9.88083409836065,62
"4394","WI-423126",2007,151,101,13.9467371428571,50
"4395","WI-423126",2008,157,86,9.54455885714286,71
"4396","WI-423126",2009,168,73,9.77928776595745,95
"4397","WI-423126",2010,142,65,9.14128105263158,77
"4398","WI-423126",2011,153,89,9.9720319047619,64
"4399","WI-423126",2012,159,67,12.5559413186813,92
"4400","WI-423126",2013,164,90,10.3250182191781,74
"4401","WI-423126",2014,149,86,8.98931161290323,63
"4402","WI-423126",2015,158,86,11.3020932394366,72
"4403","WI-423126",2016,146,64,8.24035456790124,82
"4404","WI-423126",2017,158,76,10.5819385185185,82
"4405","WI-423126",2018,144,108,12.6621245714286,36
"4406","WI-423126",2019,157,78,9.40534769230769,79
"4407","WI-423126",2020,146,67,6.46249166666667,79
"4408","WI-423126",2021,141,65,8.19716306666667,76
"4409","WI-423126",2022,130,89,6.345658,41
"4410","WI-423126",2023,150,80,9.73230536231884,70
"4411","WI-433035",1979,190,103,11.1817040697674,87
"4412","WI-433035",1980,175,105,11.9458846376812,70
"4413","WI-433035",1981,185,83,10.6346338613861,102
"4414","WI-433035",1982,186,102,12.3082789156627,84
"4415","WI-433035",1983,173,109,10.5392828571429,64
"4416","WI-433035",1984,194,95,11.5967893877551,99
"4417","WI-433035",1985,218,98,14.6401920168067,120
"4418","WI-433035",1986,187,84,11.9715257843137,103
"4419","WI-433035",1987,149,93,11.2074478181818,56
"4420","WI-433035",1988,150,85,8.49339484375,65
"4421","WI-433035",1989,172,102,11.0398162318841,70
"4422","WI-433035",1990,179,99,11.9557713924051,80
"4423","WI-433035",1991,133,90,7.64900095238095,43
"4424","WI-433035",1992,NA,105,NA,NA
"4425","WI-433035",1993,187,94,10.5706645652174,93
"4426","WI-433035",1994,165,91,9.40597369863014,74
"4427","WI-433035",1995,167,98,9.2931075,69
"4428","WI-433035",1996,180,105,10.3051410810811,75
"4429","WI-433035",1997,173,102,9.59675314285714,71
"4430","WI-433035",1998,169,82,11.3765630232558,87
"4431","WI-433035",1999,158,84,10.5668557534247,74
"4432","WI-433035",2000,194,78,11.4788628695652,116
"4433","WI-433035",2001,162,88,9.85965917808219,74
"4434","WI-433035",2002,173,97,10.3153037333333,76
"4435","WI-433035",2003,174,98,11.4252816,76
"4436","WI-433035",2004,195,82,11.0156303571429,113
"4437","WI-433035",2005,156,84,9.40729718309859,72
"4438","WI-433035",2006,147,85,8.87573557377049,62
"4439","WI-433035",2007,163,100,13.0406851612903,63
"4440","WI-433035",2008,190,91,11.6322360204082,99
"4441","WI-433035",2009,170,90,9.76248329113924,80
"4442","WI-433035",2010,143,65,8.01189792207792,78
"4443","WI-433035",2011,157,90,8.83553878787879,67
"4444","WI-433035",2012,169,68,10.9215763,101
"4445","WI-433035",2013,173,95,10.4235496103896,78
"4446","WI-433035",2014,177,92,11.0602613095238,85
"4447","WI-433035",2015,193,88,12.4131592307692,105
"4448","WI-433035",2016,187,101,13.6259058823529,86
"4449","WI-433035",2017,161,78,9.15101268292683,83
"4450","WI-433035",2018,145,108,11.2471947222222,37
"4451","WI-433035",2019,178,92,10.2898243529412,86
"4452","WI-433035",2020,179,108,12.0746177142857,71
"4453","WI-433035",2021,142,67,6.97225310810811,75
"4454","WI-433035",2022,169,107,12.3527152459016,62
"4455","WI-433035",2023,151,91,9.89799220338983,60
"4456","WI-433120",1979,190,103,11.1817040697674,87
"4457","WI-433120",1980,175,105,11.9458846376812,70
"4458","WI-433120",1981,185,83,10.6346338613861,102
"4459","WI-433120",1982,186,102,12.3082789156627,84
"4460","WI-433120",1983,173,109,10.5392828571429,64
"4461","WI-433120",1984,194,95,11.5967893877551,99
"4462","WI-433120",1985,218,98,14.6401920168067,120
"4463","WI-433120",1986,187,84,11.9715257843137,103
"4464","WI-433120",1987,149,93,11.2074478181818,56
"4465","WI-433120",1988,150,85,8.49339484375,65
"4466","WI-433120",1989,172,102,11.0398162318841,70
"4467","WI-433120",1990,179,99,11.9557713924051,80
"4468","WI-433120",1991,133,90,7.64900095238095,43
"4469","WI-433120",1992,NA,105,NA,NA
"4470","WI-433120",1993,187,94,10.5706645652174,93
"4471","WI-433120",1994,165,91,9.40597369863014,74
"4472","WI-433120",1995,167,98,9.2931075,69
"4473","WI-433120",1996,180,105,10.3051410810811,75
"4474","WI-433120",1997,173,102,9.59675314285714,71
"4475","WI-433120",1998,169,82,11.3765630232558,87
"4476","WI-433120",1999,158,84,10.5668557534247,74
"4477","WI-433120",2000,194,78,11.4788628695652,116
"4478","WI-433120",2001,162,88,9.85965917808219,74
"4479","WI-433120",2002,173,97,10.3153037333333,76
"4480","WI-433120",2003,174,98,11.4252816,76
"4481","WI-433120",2004,195,82,11.0156303571429,113
"4482","WI-433120",2005,156,84,9.40729718309859,72
"4483","WI-433120",2006,147,85,8.87573557377049,62
"4484","WI-433120",2007,163,100,13.0406851612903,63
"4485","WI-433120",2008,190,91,11.6322360204082,99
"4486","WI-433120",2009,170,90,9.76248329113924,80
"4487","WI-433120",2010,143,65,8.01189792207792,78
"4488","WI-433120",2011,157,90,8.83553878787879,67
"4489","WI-433120",2012,169,68,10.9215763,101
"4490","WI-433120",2013,173,95,10.4235496103896,78
"4491","WI-433120",2014,177,92,11.0602613095238,85
"4492","WI-433120",2015,193,88,12.4131592307692,105
"4493","WI-433120",2016,187,101,13.6259058823529,86
"4494","WI-433120",2017,161,78,9.15101268292683,83
"4495","WI-433120",2018,145,108,11.2471947222222,37
"4496","WI-433120",2019,178,92,10.2898243529412,86
"4497","WI-433120",2020,179,108,12.0746177142857,71
"4498","WI-433120",2021,142,67,6.97225310810811,75
"4499","WI-433120",2022,169,107,12.3527152459016,62
"4500","WI-433120",2023,151,91,9.89799220338983,60
"4501","WI-433247",1979,190,103,11.1817040697674,87
"4502","WI-433247",1980,175,105,11.9458846376812,70
"4503","WI-433247",1981,185,83,10.6346338613861,102
"4504","WI-433247",1982,186,102,12.3082789156627,84
"4505","WI-433247",1983,173,109,10.5392828571429,64
"4506","WI-433247",1984,194,95,11.5967893877551,99
"4507","WI-433247",1985,218,98,14.6401920168067,120
"4508","WI-433247",1986,187,84,11.9715257843137,103
"4509","WI-433247",1987,149,93,11.2074478181818,56
"4510","WI-433247",1988,150,85,8.49339484375,65
"4511","WI-433247",1989,172,102,11.0398162318841,70
"4512","WI-433247",1990,179,99,11.9557713924051,80
"4513","WI-433247",1991,133,90,7.64900095238095,43
"4514","WI-433247",1992,NA,105,NA,NA
"4515","WI-433247",1993,187,94,10.5706645652174,93
"4516","WI-433247",1994,165,91,9.40597369863014,74
"4517","WI-433247",1995,167,98,9.2931075,69
"4518","WI-433247",1996,180,105,10.3051410810811,75
"4519","WI-433247",1997,173,102,9.59675314285714,71
"4520","WI-433247",1998,169,82,11.3765630232558,87
"4521","WI-433247",1999,158,84,10.5668557534247,74
"4522","WI-433247",2000,194,78,11.4788628695652,116
"4523","WI-433247",2001,162,88,9.85965917808219,74
"4524","WI-433247",2002,173,97,10.3153037333333,76
"4525","WI-433247",2003,174,98,11.4252816,76
"4526","WI-433247",2004,195,82,11.0156303571429,113
"4527","WI-433247",2005,156,84,9.40729718309859,72
"4528","WI-433247",2006,147,85,8.87573557377049,62
"4529","WI-433247",2007,163,100,13.0406851612903,63
"4530","WI-433247",2008,190,91,11.6322360204082,99
"4531","WI-433247",2009,170,90,9.76248329113924,80
"4532","WI-433247",2010,143,65,8.01189792207792,78
"4533","WI-433247",2011,157,90,8.83553878787879,67
"4534","WI-433247",2012,169,68,10.9215763,101
"4535","WI-433247",2013,173,95,10.4235496103896,78
"4536","WI-433247",2014,177,92,11.0602613095238,85
"4537","WI-433247",2015,193,88,12.4131592307692,105
"4538","WI-433247",2016,187,101,13.6259058823529,86
"4539","WI-433247",2017,161,78,9.15101268292683,83
"4540","WI-433247",2018,145,108,11.2471947222222,37
"4541","WI-433247",2019,178,92,10.2898243529412,86
"4542","WI-433247",2020,179,108,12.0746177142857,71
"4543","WI-433247",2021,142,67,6.97225310810811,75
"4544","WI-433247",2022,169,107,12.3527152459016,62
"4545","WI-433247",2023,151,91,9.89799220338983,60
"4546","WI-433248",1979,190,102,11.8768025287356,88
"4547","WI-433248",1980,175,92,11.3789670731707,83
"4548","WI-433248",1981,183,82,10.8340489,101
"4549","WI-433248",1982,186,102,12.684596626506,84
"4550","WI-433248",1983,173,109,10.92346,64
"4551","WI-433248",1984,193,95,11.2945702061856,98
"4552","WI-433248",1985,192,93,13.2669916326531,99
"4553","WI-433248",1986,186,85,12.0310419,101
"4554","WI-433248",1987,149,93,11.5269072727273,56
"4555","WI-433248",1988,150,84,8.86792415384615,66
"4556","WI-433248",1989,172,101,11.1934205714286,71
"4557","WI-433248",1990,179,86,10.9155718478261,93
"4558","WI-433248",1991,133,74,6.5979124137931,59
"4559","WI-433248",1992,NA,105,NA,NA
"4560","WI-433248",1993,186,82,9.79993495145631,104
"4561","WI-433248",1994,165,87,9.30751883116883,78
"4562","WI-433248",1995,167,98,9.7256675,69
"4563","WI-433248",1996,180,105,10.4979198648649,75
"4564","WI-433248",1997,173,102,9.94898542857143,71
"4565","WI-433248",1998,137,82,9.94222759259259,55
"4566","WI-433248",1999,157,84,10.5377706944444,73
"4567","WI-433248",2000,193,77,11.7791899130435,116
"4568","WI-433248",2001,162,88,10.340181369863,74
"4569","WI-433248",2002,173,97,10.5726990666667,76
"4570","WI-433248",2003,174,97,11.5774338157895,77
"4571","WI-433248",2004,194,82,11.1268833333333,112
"4572","WI-433248",2005,156,84,9.75720957746479,72
"4573","WI-433248",2006,147,85,9.34563901639344,62
"4574","WI-433248",2007,152,100,12.6067249019608,52
"4575","WI-433248",2008,190,90,12.0286038383838,100
"4576","WI-433248",2009,170,89,10.013758625,81
"4577","WI-433248",2010,142,64,8.31543805194805,78
"4578","WI-433248",2011,157,89,9.06624462686567,68
"4579","WI-433248",2012,169,68,11.0397795,101
"4580","WI-433248",2013,173,94,10.8114688461538,79
"4581","WI-433248",2014,177,88,11.1117361363636,89
"4582","WI-433248",2015,192,87,12.628785,105
"4583","WI-433248",2016,147,101,10.2144877777778,46
"4584","WI-433248",2017,160,76,9.29547771084337,84
"4585","WI-433248",2018,145,108,11.8481066666667,37
"4586","WI-433248",2019,177,91,10.3693332941176,86
"4587","WI-433248",2020,171,84,9.10216965116279,87
"4588","WI-433248",2021,142,75,8.10452757575758,67
"4589","WI-433248",2022,168,107,12.6310411666667,61
"4590","WI-433248",2023,150,90,10.0646028813559,60
"4591","WI-433283",1979,190,102,11.7782933333333,88
"4592","WI-433283",1980,175,89,10.9751492941176,86
"4593","WI-433283",1981,182,81,11.2151274,101
"4594","WI-433283",1982,185,102,13.0402631707317,83
"4595","WI-433283",1983,172,108,10.9422768253968,64
"4596","WI-433283",1984,159,91,9.01451104477612,68
"4597","WI-433283",1985,186,81,12.0269540384615,105
"4598","WI-433283",1986,186,84,12.4873933663366,102
"4599","WI-433283",1987,149,92,11.3124514285714,57
"4600","WI-433283",1988,150,83,9.06209242424242,67
"4601","WI-433283",1989,172,82,9.77004764044944,90
"4602","WI-433283",1990,166,86,10.2258807594937,80
"4603","WI-433283",1991,133,74,7.03797172413793,59
"4604","WI-433283",1992,235,84,12.7394407333333,151
"4605","WI-433283",1993,185,81,10.1861266019417,104
"4606","WI-433283",1994,165,86,9.60524012820513,79
"4607","WI-433283",1995,167,98,10.3195322058824,69
"4608","WI-433283",1996,179,102,10.4577867105263,77
"4609","WI-433283",1997,172,102,10.3170137681159,70
"4610","WI-433283",1998,137,82,10.0527598148148,55
"4611","WI-433283",1999,157,83,10.7395165753425,74
"4612","WI-433283",2000,193,53,10.8170431654676,140
"4613","WI-433283",2001,162,88,10.7854936986301,74
"4614","WI-433283",2002,172,96,10.9412572,76
"4615","WI-433283",2003,174,97,11.8614593421053,77
"4616","WI-433283",2004,193,82,11.7217593636364,111
"4617","WI-433283",2005,155,83,9.83448605633803,72
"4618","WI-433283",2006,147,83,9.56484444444444,64
"4619","WI-433283",2007,151,99,12.4415588235294,52
"4620","WI-433283",2008,177,86,11.0775937777778,91
"4621","WI-433283",2009,169,74,9.10630308510638,95
"4622","WI-433283",2010,143,65,8.6832661038961,78
"4623","WI-433283",2011,156,89,9.41844196969697,67
"4624","WI-433283",2012,168,67,11.8359913,101
"4625","WI-433283",2013,173,93,11.1541849367089,80
"4626","WI-433283",2014,177,88,11.4655192045455,89
"4627","WI-433283",2015,190,87,12.9668556862745,103
"4628","WI-433283",2016,146,99,9.84203652173913,47
"4629","WI-433283",2017,160,76,9.87332,84
"4630","WI-433283",2018,145,108,12.0629508333333,37
"4631","WI-433283",2019,177,78,9.57870551020408,99
"4632","WI-433283",2020,147,84,6.60551241935484,63
"4633","WI-433283",2021,142,67,7.86836783783784,75
"4634","WI-433283",2022,132,90,6.19149243902439,42
"4635","WI-433283",2023,151,80,9.21213614285714,71
"4636","WI-433337",1979,190,103,11.1817040697674,87
"4637","WI-433337",1980,175,105,11.9458846376812,70
"4638","WI-433337",1981,185,83,10.6346338613861,102
"4639","WI-433337",1982,186,102,12.3082789156627,84
"4640","WI-433337",1983,173,109,10.5392828571429,64
"4641","WI-433337",1984,194,95,11.5967893877551,99
"4642","WI-433337",1985,218,98,14.6401920168067,120
"4643","WI-433337",1986,187,84,11.9715257843137,103
"4644","WI-433337",1987,149,93,11.2074478181818,56
"4645","WI-433337",1988,150,85,8.49339484375,65
"4646","WI-433337",1989,172,102,11.0398162318841,70
"4647","WI-433337",1990,179,99,11.9557713924051,80
"4648","WI-433337",1991,133,90,7.64900095238095,43
"4649","WI-433337",1992,NA,105,NA,NA
"4650","WI-433337",1993,187,94,10.5706645652174,93
"4651","WI-433337",1994,165,91,9.40597369863014,74
"4652","WI-433337",1995,167,98,9.2931075,69
"4653","WI-433337",1996,180,105,10.3051410810811,75
"4654","WI-433337",1997,173,102,9.59675314285714,71
"4655","WI-433337",1998,169,82,11.3765630232558,87
"4656","WI-433337",1999,158,84,10.5668557534247,74
"4657","WI-433337",2000,194,78,11.4788628695652,116
"4658","WI-433337",2001,162,88,9.85965917808219,74
"4659","WI-433337",2002,173,97,10.3153037333333,76
"4660","WI-433337",2003,174,98,11.4252816,76
"4661","WI-433337",2004,195,82,11.0156303571429,113
"4662","WI-433337",2005,156,84,9.40729718309859,72
"4663","WI-433337",2006,147,85,8.87573557377049,62
"4664","WI-433337",2007,163,100,13.0406851612903,63
"4665","WI-433337",2008,190,91,11.6322360204082,99
"4666","WI-433337",2009,170,90,9.76248329113924,80
"4667","WI-433337",2010,143,65,8.01189792207792,78
"4668","WI-433337",2011,157,90,8.83553878787879,67
"4669","WI-433337",2012,169,68,10.9215763,101
"4670","WI-433337",2013,173,95,10.4235496103896,78
"4671","WI-433337",2014,177,92,11.0602613095238,85
"4672","WI-433337",2015,193,88,12.4131592307692,105
"4673","WI-433337",2016,187,101,13.6259058823529,86
"4674","WI-433337",2017,161,78,9.15101268292683,83
"4675","WI-433337",2018,145,108,11.2471947222222,37
"4676","WI-433337",2019,178,92,10.2898243529412,86
"4677","WI-433337",2020,179,108,12.0746177142857,71
"4678","WI-433337",2021,142,67,6.97225310810811,75
"4679","WI-433337",2022,169,107,12.3527152459016,62
"4680","WI-433337",2023,151,91,9.89799220338983,60
"4681","WI-433367",1979,190,103,11.1817040697674,87
"4682","WI-433367",1980,175,105,11.9458846376812,70
"4683","WI-433367",1981,185,83,10.6346338613861,102
"4684","WI-433367",1982,186,102,12.3082789156627,84
"4685","WI-433367",1983,173,109,10.5392828571429,64
"4686","WI-433367",1984,194,95,11.5967893877551,99
"4687","WI-433367",1985,218,98,14.6401920168067,120
"4688","WI-433367",1986,187,84,11.9715257843137,103
"4689","WI-433367",1987,149,93,11.2074478181818,56
"4690","WI-433367",1988,150,85,8.49339484375,65
"4691","WI-433367",1989,172,102,11.0398162318841,70
"4692","WI-433367",1990,179,99,11.9557713924051,80
"4693","WI-433367",1991,133,90,7.64900095238095,43
"4694","WI-433367",1992,NA,105,NA,NA
"4695","WI-433367",1993,187,94,10.5706645652174,93
"4696","WI-433367",1994,165,91,9.40597369863014,74
"4697","WI-433367",1995,167,98,9.2931075,69
"4698","WI-433367",1996,180,105,10.3051410810811,75
"4699","WI-433367",1997,173,102,9.59675314285714,71
"4700","WI-433367",1998,169,82,11.3765630232558,87
"4701","WI-433367",1999,158,84,10.5668557534247,74
"4702","WI-433367",2000,194,78,11.4788628695652,116
"4703","WI-433367",2001,162,88,9.85965917808219,74
"4704","WI-433367",2002,173,97,10.3153037333333,76
"4705","WI-433367",2003,174,98,11.4252816,76
"4706","WI-433367",2004,195,82,11.0156303571429,113
"4707","WI-433367",2005,156,84,9.40729718309859,72
"4708","WI-433367",2006,147,85,8.87573557377049,62
"4709","WI-433367",2007,163,100,13.0406851612903,63
"4710","WI-433367",2008,190,91,11.6322360204082,99
"4711","WI-433367",2009,170,90,9.76248329113924,80
"4712","WI-433367",2010,143,65,8.01189792207792,78
"4713","WI-433367",2011,157,90,8.83553878787879,67
"4714","WI-433367",2012,169,68,10.9215763,101
"4715","WI-433367",2013,173,95,10.4235496103896,78
"4716","WI-433367",2014,177,92,11.0602613095238,85
"4717","WI-433367",2015,193,88,12.4131592307692,105
"4718","WI-433367",2016,187,101,13.6259058823529,86
"4719","WI-433367",2017,161,78,9.15101268292683,83
"4720","WI-433367",2018,145,108,11.2471947222222,37
"4721","WI-433367",2019,178,92,10.2898243529412,86
"4722","WI-433367",2020,179,108,12.0746177142857,71
"4723","WI-433367",2021,142,67,6.97225310810811,75
"4724","WI-433367",2022,169,107,12.3527152459016,62
"4725","WI-433367",2023,151,91,9.89799220338983,60
"4726","WI-433368",1979,190,103,11.1817040697674,87
"4727","WI-433368",1980,175,105,11.9458846376812,70
"4728","WI-433368",1981,185,83,10.6346338613861,102
"4729","WI-433368",1982,186,102,12.3082789156627,84
"4730","WI-433368",1983,173,109,10.5392828571429,64
"4731","WI-433368",1984,194,95,11.5967893877551,99
"4732","WI-433368",1985,218,98,14.6401920168067,120
"4733","WI-433368",1986,187,84,11.9715257843137,103
"4734","WI-433368",1987,149,93,11.2074478181818,56
"4735","WI-433368",1988,150,85,8.49339484375,65
"4736","WI-433368",1989,172,102,11.0398162318841,70
"4737","WI-433368",1990,179,99,11.9557713924051,80
"4738","WI-433368",1991,133,90,7.64900095238095,43
"4739","WI-433368",1992,NA,105,NA,NA
"4740","WI-433368",1993,187,94,10.5706645652174,93
"4741","WI-433368",1994,165,91,9.40597369863014,74
"4742","WI-433368",1995,167,98,9.2931075,69
"4743","WI-433368",1996,180,105,10.3051410810811,75
"4744","WI-433368",1997,173,102,9.59675314285714,71
"4745","WI-433368",1998,169,82,11.3765630232558,87
"4746","WI-433368",1999,158,84,10.5668557534247,74
"4747","WI-433368",2000,194,78,11.4788628695652,116
"4748","WI-433368",2001,162,88,9.85965917808219,74
"4749","WI-433368",2002,173,97,10.3153037333333,76
"4750","WI-433368",2003,174,98,11.4252816,76
"4751","WI-433368",2004,195,82,11.0156303571429,113
"4752","WI-433368",2005,156,84,9.40729718309859,72
"4753","WI-433368",2006,147,85,8.87573557377049,62
"4754","WI-433368",2007,163,100,13.0406851612903,63
"4755","WI-433368",2008,190,91,11.6322360204082,99
"4756","WI-433368",2009,170,90,9.76248329113924,80
"4757","WI-433368",2010,143,65,8.01189792207792,78
"4758","WI-433368",2011,157,90,8.83553878787879,67
"4759","WI-433368",2012,169,68,10.9215763,101
"4760","WI-433368",2013,173,95,10.4235496103896,78
"4761","WI-433368",2014,177,92,11.0602613095238,85
"4762","WI-433368",2015,193,88,12.4131592307692,105
"4763","WI-433368",2016,187,101,13.6259058823529,86
"4764","WI-433368",2017,161,78,9.15101268292683,83
"4765","WI-433368",2018,145,108,11.2471947222222,37
"4766","WI-433368",2019,178,92,10.2898243529412,86
"4767","WI-433368",2020,179,108,12.0746177142857,71
"4768","WI-433368",2021,142,67,6.97225310810811,75
"4769","WI-433368",2022,169,107,12.3527152459016,62
"4770","WI-433368",2023,151,91,9.89799220338983,60
"4771","WI-433371",1979,190,103,11.1817040697674,87
"4772","WI-433371",1980,175,105,11.9458846376812,70
"4773","WI-433371",1981,185,83,10.6346338613861,102
"4774","WI-433371",1982,186,102,12.3082789156627,84
"4775","WI-433371",1983,173,109,10.5392828571429,64
"4776","WI-433371",1984,194,95,11.5967893877551,99
"4777","WI-433371",1985,218,98,14.6401920168067,120
"4778","WI-433371",1986,187,84,11.9715257843137,103
"4779","WI-433371",1987,149,93,11.2074478181818,56
"4780","WI-433371",1988,150,85,8.49339484375,65
"4781","WI-433371",1989,172,102,11.0398162318841,70
"4782","WI-433371",1990,179,99,11.9557713924051,80
"4783","WI-433371",1991,133,90,7.64900095238095,43
"4784","WI-433371",1992,NA,105,NA,NA
"4785","WI-433371",1993,187,94,10.5706645652174,93
"4786","WI-433371",1994,165,91,9.40597369863014,74
"4787","WI-433371",1995,167,98,9.2931075,69
"4788","WI-433371",1996,180,105,10.3051410810811,75
"4789","WI-433371",1997,173,102,9.59675314285714,71
"4790","WI-433371",1998,169,82,11.3765630232558,87
"4791","WI-433371",1999,158,84,10.5668557534247,74
"4792","WI-433371",2000,194,78,11.4788628695652,116
"4793","WI-433371",2001,162,88,9.85965917808219,74
"4794","WI-433371",2002,173,97,10.3153037333333,76
"4795","WI-433371",2003,174,98,11.4252816,76
"4796","WI-433371",2004,195,82,11.0156303571429,113
"4797","WI-433371",2005,156,84,9.40729718309859,72
"4798","WI-433371",2006,147,85,8.87573557377049,62
"4799","WI-433371",2007,163,100,13.0406851612903,63
"4800","WI-433371",2008,190,91,11.6322360204082,99
"4801","WI-433371",2009,170,90,9.76248329113924,80
"4802","WI-433371",2010,143,65,8.01189792207792,78
"4803","WI-433371",2011,157,90,8.83553878787879,67
"4804","WI-433371",2012,169,68,10.9215763,101
"4805","WI-433371",2013,173,95,10.4235496103896,78
"4806","WI-433371",2014,177,92,11.0602613095238,85
"4807","WI-433371",2015,193,88,12.4131592307692,105
"4808","WI-433371",2016,187,101,13.6259058823529,86
"4809","WI-433371",2017,161,78,9.15101268292683,83
"4810","WI-433371",2018,145,108,11.2471947222222,37
"4811","WI-433371",2019,178,92,10.2898243529412,86
"4812","WI-433371",2020,179,108,12.0746177142857,71
"4813","WI-433371",2021,142,67,6.97225310810811,75
"4814","WI-433371",2022,169,107,12.3527152459016,62
"4815","WI-433371",2023,151,91,9.89799220338983,60
"4816","WI-443053",1979,190,105,7.26729833333333,85
"4817","WI-443053",1980,175,107,11.1603092537313,68
"4818","WI-443053",1981,185,95,11.017298988764,90
"4819","WI-443053",1982,185,102,12.3347568292683,83
"4820","WI-443053",1983,173,109,10.604016031746,64
"4821","WI-443053",1984,193,101,11.2662850549451,92
"4822","WI-443053",1985,218,98,14.6222035294118,120
"4823","WI-443053",1986,187,86,12.00674,101
"4824","WI-443053",1987,149,93,11.4233572727273,56
"4825","WI-443053",1988,150,85,8.465563125,65
"4826","WI-443053",1989,172,102,10.9321389855072,70
"4827","WI-443053",1990,179,99,11.9004907594937,80
"4828","WI-443053",1991,150,90,10.5208008474576,60
"4829","WI-443053",1992,NA,105,NA,NA
"4830","WI-443053",1993,222,94,12.550081496063,128
"4831","WI-443053",1994,165,95,9.84871130434783,70
"4832","WI-443053",1995,167,98,9.27277191176471,69
"4833","WI-443053",1996,180,106,10.3883789041096,74
"4834","WI-443053",1997,173,104,9.92476,69
"4835","WI-443053",1998,168,82,11.3406058823529,86
"4836","WI-443053",1999,158,85,10.4631066666667,73
"4837","WI-443053",2000,193,78,11.4054471052632,115
"4838","WI-443053",2001,162,89,9.95122791666667,73
"4839","WI-443053",2002,173,97,10.2087406666667,76
"4840","WI-443053",2003,183,98,12.3001147619048,85
"4841","WI-443053",2004,194,82,10.6931133333333,112
"4842","WI-443053",2005,156,85,9.595049,71
"4843","WI-443053",2006,146,86,8.7074793220339,60
"4844","WI-443053",2007,163,101,13.2152655737705,62
"4845","WI-443053",2008,191,91,11.3589270707071,100
"4846","WI-443053",2009,170,90,9.57033506329114,80
"4847","WI-443053",2010,142,66,8.08853826666667,76
"4848","WI-443053",2011,157,90,8.86098848484849,67
"4849","WI-443053",2012,169,68,10.5351698,101
"4850","WI-443053",2013,173,104,11.4355726470588,69
"4851","WI-443053",2014,177,107,12.7767408695652,70
"4852","WI-443053",2015,193,88,12.3574204807692,105
"4853","WI-443053",2016,169,101,12.4612562686567,68
"4854","WI-443053",2017,161,78,9.08984658536585,83
"4855","WI-443053",2018,145,109,11.3056514285714,36
"4856","WI-443053",2019,178,103,11.2877127027027,75
"4857","WI-443053",2020,179,109,12.2674791304348,70
"4858","WI-443053",2021,142,76,7.56167769230769,66
"4859","WI-443053",2022,169,108,12.3449175,61
"4860","WI-443053",2023,151,96,10.2983012962963,55
"4861","WI-443060",1979,190,122,8.6590623880597,68
"4862","WI-443060",1980,175,106,11.0088302941176,69
"4863","WI-443060",1981,185,95,10.887822247191,90
"4864","WI-443060",1982,185,102,12.1575462195122,83
"4865","WI-443060",1983,173,109,10.4955087301587,64
"4866","WI-443060",1984,193,101,11.1600013186813,92
"4867","WI-443060",1985,218,98,14.3910457983193,120
"4868","WI-443060",1986,187,86,11.8441623,101
"4869","WI-443060",1987,150,93,11.4404051785714,57
"4870","WI-443060",1988,150,86,8.44087063492064,64
"4871","WI-443060",1989,173,102,10.8133124285714,71
"4872","WI-443060",1990,179,99,11.7368237974684,80
"4873","WI-443060",1991,151,91,10.7587662711864,60
"4874","WI-443060",1992,NA,105,NA,NA
"4875","WI-443060",1993,222,94,12.3697165354331,128
"4876","WI-443060",1994,165,95,9.64943579710145,70
"4877","WI-443060",1995,167,98,9.07504720588235,69
"4878","WI-443060",1996,181,106,10.41944,75
"4879","WI-443060",1997,173,104,9.77459911764706,69
"4880","WI-443060",1998,169,82,11.2486558139535,87
"4881","WI-443060",1999,158,85,10.2323115277778,73
"4882","WI-443060",2000,193,78,11.1809405263158,115
"4883","WI-443060",2001,163,89,9.92762178082192,74
"4884","WI-443060",2002,173,97,9.98790786666667,76
"4885","WI-443060",2003,183,98,12.1720444047619,85
"4886","WI-443060",2004,194,93,11.192073,101
"4887","WI-443060",2005,157,85,9.62826464788732,72
"4888","WI-443060",2006,147,86,8.765628,61
"4889","WI-443060",2007,163,101,13.0795072131148,62
"4890","WI-443060",2008,191,92,11.2620621428571,99
"4891","WI-443060",2009,170,98,10.4287438028169,72
"4892","WI-443060",2010,142,66,7.95447573333333,76
"4893","WI-443060",2011,180,90,10.6927458426966,90
"4894","WI-443060",2012,169,69,10.4837593939394,100
"4895","WI-443060",2013,173,108,11.7973890625,65
"4896","WI-443060",2014,177,107,12.605091884058,70
"4897","WI-443060",2015,193,88,12.2332463461538,105
"4898","WI-443060",2016,188,101,13.6859224418605,87
"4899","WI-443060",2017,161,78,8.90568109756098,83
"4900","WI-443060",2018,145,109,11.0960525714286,36
"4901","WI-443060",2019,178,103,11.0351794594595,75
"4902","WI-443060",2020,179,109,12.1350063768116,70
"4903","WI-443060",2021,155,76,8.5075958974359,79
"4904","WI-443060",2022,169,108,12.1270781666667,61
"4905","WI-443060",2023,151,96,10.0972024074074,55
"4906","WI-443100",1979,190,122,8.6590623880597,68
"4907","WI-443100",1980,175,106,11.0088302941176,69
"4908","WI-443100",1981,185,95,10.887822247191,90
"4909","WI-443100",1982,185,102,12.1575462195122,83
"4910","WI-443100",1983,173,109,10.4955087301587,64
"4911","WI-443100",1984,193,101,11.1600013186813,92
"4912","WI-443100",1985,218,98,14.3910457983193,120
"4913","WI-443100",1986,187,86,11.8441623,101
"4914","WI-443100",1987,150,93,11.4404051785714,57
"4915","WI-443100",1988,150,86,8.44087063492064,64
"4916","WI-443100",1989,173,102,10.8133124285714,71
"4917","WI-443100",1990,179,99,11.7368237974684,80
"4918","WI-443100",1991,151,91,10.7587662711864,60
"4919","WI-443100",1992,NA,105,NA,NA
"4920","WI-443100",1993,222,94,12.3697165354331,128
"4921","WI-443100",1994,165,95,9.64943579710145,70
"4922","WI-443100",1995,167,98,9.07504720588235,69
"4923","WI-443100",1996,181,106,10.41944,75
"4924","WI-443100",1997,173,104,9.77459911764706,69
"4925","WI-443100",1998,169,82,11.2486558139535,87
"4926","WI-443100",1999,158,85,10.2323115277778,73
"4927","WI-443100",2000,193,78,11.1809405263158,115
"4928","WI-443100",2001,163,89,9.92762178082192,74
"4929","WI-443100",2002,173,97,9.98790786666667,76
"4930","WI-443100",2003,183,98,12.1720444047619,85
"4931","WI-443100",2004,194,93,11.192073,101
"4932","WI-443100",2005,157,85,9.62826464788732,72
"4933","WI-443100",2006,147,86,8.765628,61
"4934","WI-443100",2007,163,101,13.0795072131148,62
"4935","WI-443100",2008,191,92,11.2620621428571,99
"4936","WI-443100",2009,170,98,10.4287438028169,72
"4937","WI-443100",2010,142,66,7.95447573333333,76
"4938","WI-443100",2011,180,90,10.6927458426966,90
"4939","WI-443100",2012,169,69,10.4837593939394,100
"4940","WI-443100",2013,173,108,11.7973890625,65
"4941","WI-443100",2014,177,107,12.605091884058,70
"4942","WI-443100",2015,193,88,12.2332463461538,105
"4943","WI-443100",2016,188,101,13.6859224418605,87
"4944","WI-443100",2017,161,78,8.90568109756098,83
"4945","WI-443100",2018,145,109,11.0960525714286,36
"4946","WI-443100",2019,178,103,11.0351794594595,75
"4947","WI-443100",2020,179,109,12.1350063768116,70
"4948","WI-443100",2021,155,76,8.5075958974359,79
"4949","WI-443100",2022,169,108,12.1270781666667,61
"4950","WI-443100",2023,151,96,10.0972024074074,55
"4951","WI-443123",1979,190,105,7.26729833333333,85
"4952","WI-443123",1980,175,107,11.1603092537313,68
"4953","WI-443123",1981,185,95,11.017298988764,90
"4954","WI-443123",1982,185,102,12.3347568292683,83
"4955","WI-443123",1983,173,109,10.604016031746,64
"4956","WI-443123",1984,193,101,11.2662850549451,92
"4957","WI-443123",1985,218,98,14.6222035294118,120
"4958","WI-443123",1986,187,86,12.00674,101
"4959","WI-443123",1987,149,93,11.4233572727273,56
"4960","WI-443123",1988,150,85,8.465563125,65
"4961","WI-443123",1989,172,102,10.9321389855072,70
"4962","WI-443123",1990,179,99,11.9004907594937,80
"4963","WI-443123",1991,150,90,10.5208008474576,60
"4964","WI-443123",1992,NA,105,NA,NA
"4965","WI-443123",1993,222,94,12.550081496063,128
"4966","WI-443123",1994,165,95,9.84871130434783,70
"4967","WI-443123",1995,167,98,9.27277191176471,69
"4968","WI-443123",1996,180,106,10.3883789041096,74
"4969","WI-443123",1997,173,104,9.92476,69
"4970","WI-443123",1998,168,82,11.3406058823529,86
"4971","WI-443123",1999,158,85,10.4631066666667,73
"4972","WI-443123",2000,193,78,11.4054471052632,115
"4973","WI-443123",2001,162,89,9.95122791666667,73
"4974","WI-443123",2002,173,97,10.2087406666667,76
"4975","WI-443123",2003,183,98,12.3001147619048,85
"4976","WI-443123",2004,194,82,10.6931133333333,112
"4977","WI-443123",2005,156,85,9.595049,71
"4978","WI-443123",2006,146,86,8.7074793220339,60
"4979","WI-443123",2007,163,101,13.2152655737705,62
"4980","WI-443123",2008,191,91,11.3589270707071,100
"4981","WI-443123",2009,170,90,9.57033506329114,80
"4982","WI-443123",2010,142,66,8.08853826666667,76
"4983","WI-443123",2011,157,90,8.86098848484849,67
"4984","WI-443123",2012,169,68,10.5351698,101
"4985","WI-443123",2013,173,104,11.4355726470588,69
"4986","WI-443123",2014,177,107,12.7767408695652,70
"4987","WI-443123",2015,193,88,12.3574204807692,105
"4988","WI-443123",2016,169,101,12.4612562686567,68
"4989","WI-443123",2017,161,78,9.08984658536585,83
"4990","WI-443123",2018,145,109,11.3056514285714,36
"4991","WI-443123",2019,178,103,11.2877127027027,75
"4992","WI-443123",2020,179,109,12.2674791304348,70
"4993","WI-443123",2021,142,76,7.56167769230769,66
"4994","WI-443123",2022,169,108,12.3449175,61
"4995","WI-443123",2023,151,96,10.2983012962963,55
"4996","WI-443134",1979,190,124,8.96698907692308,66
"4997","WI-443134",1980,175,107,12.0504676119403,68
"4998","WI-443134",1981,185,96,11.1192511363636,89
"4999","WI-443134",1982,185,102,12.065987804878,83
"5000","WI-443134",1983,173,110,10.4749927419355,63
"5001","WI-443134",1984,193,101,10.9802272527473,92
"5002","WI-443134",1985,NA,99,NA,NA
"5003","WI-443134",1986,187,86,11.6198657,101
"5004","WI-443134",1987,150,93,11.2692278571429,57
"5005","WI-443134",1988,150,87,8.48664935483871,63
"5006","WI-443134",1989,183,102,11.584838875,81
"5007","WI-443134",1990,180,99,11.651389125,81
"5008","WI-443134",1991,177,91,12.7397698823529,86
"5009","WI-443134",1992,NA,105,NA,NA
"5010","WI-443134",1993,223,94,12.286562578125,129
"5011","WI-443134",1994,165,95,9.51084797101449,70
"5012","WI-443134",1995,167,99,9.01775910447761,68
"5013","WI-443134",1996,181,106,10.1698622972973,75
"5014","WI-443134",1997,173,104,9.50931926470588,69
"5015","WI-443134",1998,169,82,11.0672420930233,87
"5016","WI-443134",1999,158,86,10.0882097183099,72
"5017","WI-443134",2000,212,78,11.8476005263158,134
"5018","WI-443134",2001,163,89,9.90407726027397,74
"5019","WI-443134",2002,173,97,9.82342853333333,76
"5020","WI-443134",2003,183,98,12.0844335714286,85
"5021","WI-443134",2004,195,93,11.1007011881188,102
"5022","WI-443134",2005,157,85,9.49369183098591,72
"5023","WI-443134",2006,147,86,8.65195633333333,61
"5024","WI-443134",2007,163,101,13.0869363934426,62
"5025","WI-443134",2008,191,92,11.1984462244898,99
"5026","WI-443134",2009,170,98,10.1911776056338,72
"5027","WI-443134",2010,142,65,7.79681131578947,77
"5028","WI-443134",2011,180,90,10.5647612359551,90
"5029","WI-443134",2012,169,69,10.3365062626263,100
"5030","WI-443134",2013,173,108,11.72683296875,65
"5031","WI-443134",2014,177,107,12.4822436231884,70
"5032","WI-443134",2015,193,88,12.0730156730769,105
"5033","WI-443134",2016,188,101,13.5053260465116,87
"5034","WI-443134",2017,161,79,8.73033222222222,82
"5035","WI-443134",2018,145,109,11.0270794285714,36
"5036","WI-443134",2019,178,103,10.9125014864865,75
"5037","WI-443134",2020,179,111,12.2427250746269,68
"5038","WI-443134",2021,155,77,8.45442818181818,78
"5039","WI-443134",2022,169,109,12.1510822033898,60
"5040","WI-443134",2023,151,96,10.0944535185185,55
"5041","WI-443140",1979,190,123,9.27550424242424,67
"5042","WI-443140",1980,175,107,12.2169789552239,68
"5043","WI-443140",1981,185,94,10.9526598888889,91
"5044","WI-443140",1982,186,102,12.30282,84
"5045","WI-443140",1983,173,110,10.5649625806452,63
"5046","WI-443140",1984,193,101,11.1549350549451,92
"5047","WI-443140",1985,218,99,14.5675772881356,119
"5048","WI-443140",1986,187,86,11.7986157,101
"5049","WI-443140",1987,150,93,11.3681392857143,57
"5050","WI-443140",1988,150,86,8.39573174603175,64
"5051","WI-443140",1989,172,102,10.696971884058,70
"5052","WI-443140",1990,180,99,11.81574475,81
"5053","WI-443140",1991,150,91,10.5253972413793,59
"5054","WI-443140",1992,NA,105,NA,NA
"5055","WI-443140",1993,222,94,12.3352075590551,128
"5056","WI-443140",1994,165,95,9.66721144927536,70
"5057","WI-443140",1995,167,98,9.04092397058823,69
"5058","WI-443140",1996,181,106,10.3119651351351,75
"5059","WI-443140",1997,173,104,9.64902544117647,69
"5060","WI-443140",1998,169,82,11.2465665116279,87
"5061","WI-443140",1999,158,86,10.3031087323944,72
"5062","WI-443140",2000,224,78,12.6345162068966,146
"5063","WI-443140",2001,162,89,9.88265152777778,73
"5064","WI-443140",2002,173,97,10.0094702666667,76
"5065","WI-443140",2003,183,98,12.1818104761905,85
"5066","WI-443140",2004,195,93,11.2915266336634,102
"5067","WI-443140",2005,156,85,9.42306157142857,71
"5068","WI-443140",2006,147,86,8.75026333333333,61
"5069","WI-443140",2007,163,101,13.2069418032787,62
"5070","WI-443140",2008,191,92,11.4064337755102,99
"5071","WI-443140",2009,170,98,10.3929821126761,72
"5072","WI-443140",2010,142,65,7.91626026315789,77
"5073","WI-443140",2011,157,90,8.70533060606061,67
"5074","WI-443140",2012,169,68,10.3409509,101
"5075","WI-443140",2013,173,104,11.3824938235294,69
"5076","WI-443140",2014,177,107,12.6806131884058,70
"5077","WI-443140",2015,193,88,12.1664646153846,105
"5078","WI-443140",2016,188,101,13.6019837209302,87
"5079","WI-443140",2017,161,78,8.84727829268293,83
"5080","WI-443140",2018,145,109,11.2163648571429,36
"5081","WI-443140",2019,178,103,11.1356860810811,75
"5082","WI-443140",2020,179,111,12.3406734328358,68
"5083","WI-443140",2021,155,76,8.59794012820513,79
"5084","WI-443140",2022,169,109,12.3724794915254,60
"5085","WI-443140",2023,151,95,10.0410343636364,56
"5086","WI-443147",1979,190,105,7.26729833333333,85
"5087","WI-443147",1980,175,107,11.1603092537313,68
"5088","WI-443147",1981,185,95,11.017298988764,90
"5089","WI-443147",1982,185,102,12.3347568292683,83
"5090","WI-443147",1983,173,109,10.604016031746,64
"5091","WI-443147",1984,193,101,11.2662850549451,92
"5092","WI-443147",1985,218,98,14.6222035294118,120
"5093","WI-443147",1986,187,86,12.00674,101
"5094","WI-443147",1987,149,93,11.4233572727273,56
"5095","WI-443147",1988,150,85,8.465563125,65
"5096","WI-443147",1989,172,102,10.9321389855072,70
"5097","WI-443147",1990,179,99,11.9004907594937,80
"5098","WI-443147",1991,150,90,10.5208008474576,60
"5099","WI-443147",1992,NA,105,NA,NA
"5100","WI-443147",1993,222,94,12.550081496063,128
"5101","WI-443147",1994,165,95,9.84871130434783,70
"5102","WI-443147",1995,167,98,9.27277191176471,69
"5103","WI-443147",1996,180,106,10.3883789041096,74
"5104","WI-443147",1997,173,104,9.92476,69
"5105","WI-443147",1998,168,82,11.3406058823529,86
"5106","WI-443147",1999,158,85,10.4631066666667,73
"5107","WI-443147",2000,193,78,11.4054471052632,115
"5108","WI-443147",2001,162,89,9.95122791666667,73
"5109","WI-443147",2002,173,97,10.2087406666667,76
"5110","WI-443147",2003,183,98,12.3001147619048,85
"5111","WI-443147",2004,194,82,10.6931133333333,112
"5112","WI-443147",2005,156,85,9.595049,71
"5113","WI-443147",2006,146,86,8.7074793220339,60
"5114","WI-443147",2007,163,101,13.2152655737705,62
"5115","WI-443147",2008,191,91,11.3589270707071,100
"5116","WI-443147",2009,170,90,9.57033506329114,80
"5117","WI-443147",2010,142,66,8.08853826666667,76
"5118","WI-443147",2011,157,90,8.86098848484849,67
"5119","WI-443147",2012,169,68,10.5351698,101
"5120","WI-443147",2013,173,104,11.4355726470588,69
"5121","WI-443147",2014,177,107,12.7767408695652,70
"5122","WI-443147",2015,193,88,12.3574204807692,105
"5123","WI-443147",2016,169,101,12.4612562686567,68
"5124","WI-443147",2017,161,78,9.08984658536585,83
"5125","WI-443147",2018,145,109,11.3056514285714,36
"5126","WI-443147",2019,178,103,11.2877127027027,75
"5127","WI-443147",2020,179,109,12.2674791304348,70
"5128","WI-443147",2021,142,76,7.56167769230769,66
"5129","WI-443147",2022,169,108,12.3449175,61
"5130","WI-443147",2023,151,96,10.2983012962963,55
"5131","WI-443187",1979,190,101,10.6416647727273,89
"5132","WI-443187",1980,175,104,12.6522078571429,71
"5133","WI-443187",1981,185,81,10.7029791262136,104
"5134","WI-443187",1982,185,101,12.045894939759,84
"5135","WI-443187",1983,173,109,10.6404741269841,64
"5136","WI-443187",1984,193,93,11.3982481818182,100
"5137","WI-443187",1985,218,98,14.541781092437,120
"5138","WI-443187",1986,187,84,11.8871200980392,103
"5139","WI-443187",1987,150,93,11.5313644642857,57
"5140","WI-443187",1988,150,85,8.52513359375,65
"5141","WI-443187",1989,172,102,10.9047391304348,70
"5142","WI-443187",1990,178,99,11.8287764102564,79
"5143","WI-443187",1991,133,90,7.63095761904762,43
"5144","WI-443187",1992,NA,105,NA,NA
"5145","WI-443187",1993,222,94,12.5395005511811,128
"5146","WI-443187",1994,165,95,9.83455753623188,70
"5147","WI-443187",1995,167,98,9.22233617647059,69
"5148","WI-443187",1996,180,106,10.4494876712329,74
"5149","WI-443187",1997,173,104,9.92786205882353,69
"5150","WI-443187",1998,168,82,11.2066907058824,86
"5151","WI-443187",1999,158,85,10.4011490277778,73
"5152","WI-443187",2000,193,78,11.2454963157895,115
"5153","WI-443187",2001,162,89,9.73801194444444,73
"5154","WI-443187",2002,173,97,10.1762421333333,76
"5155","WI-443187",2003,183,98,12.2747232142857,85
"5156","WI-443187",2004,194,82,10.6791773873874,112
"5157","WI-443187",2005,157,85,9.64741154929578,72
"5158","WI-443187",2006,146,86,8.65663254237288,60
"5159","WI-443187",2007,163,101,13.1663427868852,62
"5160","WI-443187",2008,191,92,11.3634654081633,99
"5161","WI-443187",2009,169,98,10.5030171428571,71
"5162","WI-443187",2010,142,66,7.93916333333333,76
"5163","WI-443187",2011,179,90,10.7102248863636,89
"5164","WI-443187",2012,169,68,10.4832946,101
"5165","WI-443187",2013,173,108,11.8305928125,65
"5166","WI-443187",2014,172,107,12.27686890625,65
"5167","WI-443187",2015,192,87,12.1686739423077,105
"5168","WI-443187",2016,169,101,12.4797970149254,68
"5169","WI-443187",2017,161,79,9.07610691358025,82
"5170","WI-443187",2018,145,109,11.3440431428571,36
"5171","WI-443187",2019,178,103,11.2838067567568,75
"5172","WI-443187",2020,179,109,12.3313379710145,70
"5173","WI-443187",2021,142,75,7.28539878787879,67
"5174","WI-443187",2022,168,108,12.2505762711864,60
"5175","WI-443187",2023,151,96,10.0864955555556,55
"5176","WI-443210",1979,190,123,9.27550424242424,67
"5177","WI-443210",1980,175,107,12.2169789552239,68
"5178","WI-443210",1981,185,94,10.9526598888889,91
"5179","WI-443210",1982,186,102,12.30282,84
"5180","WI-443210",1983,173,110,10.5649625806452,63
"5181","WI-443210",1984,193,101,11.1549350549451,92
"5182","WI-443210",1985,218,99,14.5675772881356,119
"5183","WI-443210",1986,187,86,11.7986157,101
"5184","WI-443210",1987,150,93,11.3681392857143,57
"5185","WI-443210",1988,150,86,8.39573174603175,64
"5186","WI-443210",1989,172,102,10.696971884058,70
"5187","WI-443210",1990,180,99,11.81574475,81
"5188","WI-443210",1991,150,91,10.5253972413793,59
"5189","WI-443210",1992,NA,105,NA,NA
"5190","WI-443210",1993,222,94,12.3352075590551,128
"5191","WI-443210",1994,165,95,9.66721144927536,70
"5192","WI-443210",1995,167,98,9.04092397058823,69
"5193","WI-443210",1996,181,106,10.3119651351351,75
"5194","WI-443210",1997,173,104,9.64902544117647,69
"5195","WI-443210",1998,169,82,11.2465665116279,87
"5196","WI-443210",1999,158,86,10.3031087323944,72
"5197","WI-443210",2000,224,78,12.6345162068966,146
"5198","WI-443210",2001,162,89,9.88265152777778,73
"5199","WI-443210",2002,173,97,10.0094702666667,76
"5200","WI-443210",2003,183,98,12.1818104761905,85
"5201","WI-443210",2004,195,93,11.2915266336634,102
"5202","WI-443210",2005,156,85,9.42306157142857,71
"5203","WI-443210",2006,147,86,8.75026333333333,61
"5204","WI-443210",2007,163,101,13.2069418032787,62
"5205","WI-443210",2008,191,92,11.4064337755102,99
"5206","WI-443210",2009,170,98,10.3929821126761,72
"5207","WI-443210",2010,142,65,7.91626026315789,77
"5208","WI-443210",2011,157,90,8.70533060606061,67
"5209","WI-443210",2012,169,68,10.3409509,101
"5210","WI-443210",2013,173,104,11.3824938235294,69
"5211","WI-443210",2014,177,107,12.6806131884058,70
"5212","WI-443210",2015,193,88,12.1664646153846,105
"5213","WI-443210",2016,188,101,13.6019837209302,87
"5214","WI-443210",2017,161,78,8.84727829268293,83
"5215","WI-443210",2018,145,109,11.2163648571429,36
"5216","WI-443210",2019,178,103,11.1356860810811,75
"5217","WI-443210",2020,179,111,12.3406734328358,68
"5218","WI-443210",2021,155,76,8.59794012820513,79
"5219","WI-443210",2022,169,109,12.3724794915254,60
"5220","WI-443210",2023,151,95,10.0410343636364,56
"5221","WI-443264",1979,190,105,7.26729833333333,85
"5222","WI-443264",1980,175,107,11.1603092537313,68
"5223","WI-443264",1981,185,95,11.017298988764,90
"5224","WI-443264",1982,185,102,12.3347568292683,83
"5225","WI-443264",1983,173,109,10.604016031746,64
"5226","WI-443264",1984,193,101,11.2662850549451,92
"5227","WI-443264",1985,218,98,14.6222035294118,120
"5228","WI-443264",1986,187,86,12.00674,101
"5229","WI-443264",1987,149,93,11.4233572727273,56
"5230","WI-443264",1988,150,85,8.465563125,65
"5231","WI-443264",1989,172,102,10.9321389855072,70
"5232","WI-443264",1990,179,99,11.9004907594937,80
"5233","WI-443264",1991,150,90,10.5208008474576,60
"5234","WI-443264",1992,NA,105,NA,NA
"5235","WI-443264",1993,222,94,12.550081496063,128
"5236","WI-443264",1994,165,95,9.84871130434783,70
"5237","WI-443264",1995,167,98,9.27277191176471,69
"5238","WI-443264",1996,180,106,10.3883789041096,74
"5239","WI-443264",1997,173,104,9.92476,69
"5240","WI-443264",1998,168,82,11.3406058823529,86
"5241","WI-443264",1999,158,85,10.4631066666667,73
"5242","WI-443264",2000,193,78,11.4054471052632,115
"5243","WI-443264",2001,162,89,9.95122791666667,73
"5244","WI-443264",2002,173,97,10.2087406666667,76
"5245","WI-443264",2003,183,98,12.3001147619048,85
"5246","WI-443264",2004,194,82,10.6931133333333,112
"5247","WI-443264",2005,156,85,9.595049,71
"5248","WI-443264",2006,146,86,8.7074793220339,60
"5249","WI-443264",2007,163,101,13.2152655737705,62
"5250","WI-443264",2008,191,91,11.3589270707071,100
"5251","WI-443264",2009,170,90,9.57033506329114,80
"5252","WI-443264",2010,142,66,8.08853826666667,76
"5253","WI-443264",2011,157,90,8.86098848484849,67
"5254","WI-443264",2012,169,68,10.5351698,101
"5255","WI-443264",2013,173,104,11.4355726470588,69
"5256","WI-443264",2014,177,107,12.7767408695652,70
"5257","WI-443264",2015,193,88,12.3574204807692,105
"5258","WI-443264",2016,169,101,12.4612562686567,68
"5259","WI-443264",2017,161,78,9.08984658536585,83
"5260","WI-443264",2018,145,109,11.3056514285714,36
"5261","WI-443264",2019,178,103,11.2877127027027,75
"5262","WI-443264",2020,179,109,12.2674791304348,70
"5263","WI-443264",2021,142,76,7.56167769230769,66
"5264","WI-443264",2022,169,108,12.3449175,61
"5265","WI-443264",2023,151,96,10.2983012962963,55
"5266","WI-443386",1979,190,124,8.96698907692308,66
"5267","WI-443386",1980,175,107,12.0504676119403,68
"5268","WI-443386",1981,185,96,11.1192511363636,89
"5269","WI-443386",1982,185,102,12.065987804878,83
"5270","WI-443386",1983,173,110,10.4749927419355,63
"5271","WI-443386",1984,193,101,10.9802272527473,92
"5272","WI-443386",1985,NA,99,NA,NA
"5273","WI-443386",1986,187,86,11.6198657,101
"5274","WI-443386",1987,150,93,11.2692278571429,57
"5275","WI-443386",1988,150,87,8.48664935483871,63
"5276","WI-443386",1989,183,102,11.584838875,81
"5277","WI-443386",1990,180,99,11.651389125,81
"5278","WI-443386",1991,177,91,12.7397698823529,86
"5279","WI-443386",1992,NA,105,NA,NA
"5280","WI-443386",1993,223,94,12.286562578125,129
"5281","WI-443386",1994,165,95,9.51084797101449,70
"5282","WI-443386",1995,167,99,9.01775910447761,68
"5283","WI-443386",1996,181,106,10.1698622972973,75
"5284","WI-443386",1997,173,104,9.50931926470588,69
"5285","WI-443386",1998,169,82,11.0672420930233,87
"5286","WI-443386",1999,158,86,10.0882097183099,72
"5287","WI-443386",2000,212,78,11.8476005263158,134
"5288","WI-443386",2001,163,89,9.90407726027397,74
"5289","WI-443386",2002,173,97,9.82342853333333,76
"5290","WI-443386",2003,183,98,12.0844335714286,85
"5291","WI-443386",2004,195,93,11.1007011881188,102
"5292","WI-443386",2005,157,85,9.49369183098591,72
"5293","WI-443386",2006,147,86,8.65195633333333,61
"5294","WI-443386",2007,163,101,13.0869363934426,62
"5295","WI-443386",2008,191,92,11.1984462244898,99
"5296","WI-443386",2009,170,98,10.1911776056338,72
"5297","WI-443386",2010,142,65,7.79681131578947,77
"5298","WI-443386",2011,180,90,10.5647612359551,90
"5299","WI-443386",2012,169,69,10.3365062626263,100
"5300","WI-443386",2013,173,108,11.72683296875,65
"5301","WI-443386",2014,177,107,12.4822436231884,70
"5302","WI-443386",2015,193,88,12.0730156730769,105
"5303","WI-443386",2016,188,101,13.5053260465116,87
"5304","WI-443386",2017,161,79,8.73033222222222,82
"5305","WI-443386",2018,145,109,11.0270794285714,36
"5306","WI-443386",2019,178,103,10.9125014864865,75
"5307","WI-443386",2020,179,111,12.2427250746269,68
"5308","WI-443386",2021,155,77,8.45442818181818,78
"5309","WI-443386",2022,169,109,12.1510822033898,60
"5310","WI-443386",2023,151,96,10.0944535185185,55
"5311","WI-443391",1979,190,105,7.26729833333333,85
"5312","WI-443391",1980,175,107,11.1603092537313,68
"5313","WI-443391",1981,185,95,11.017298988764,90
"5314","WI-443391",1982,185,102,12.3347568292683,83
"5315","WI-443391",1983,173,109,10.604016031746,64
"5316","WI-443391",1984,193,101,11.2662850549451,92
"5317","WI-443391",1985,218,98,14.6222035294118,120
"5318","WI-443391",1986,187,86,12.00674,101
"5319","WI-443391",1987,149,93,11.4233572727273,56
"5320","WI-443391",1988,150,85,8.465563125,65
"5321","WI-443391",1989,172,102,10.9321389855072,70
"5322","WI-443391",1990,179,99,11.9004907594937,80
"5323","WI-443391",1991,150,90,10.5208008474576,60
"5324","WI-443391",1992,NA,105,NA,NA
"5325","WI-443391",1993,222,94,12.550081496063,128
"5326","WI-443391",1994,165,95,9.84871130434783,70
"5327","WI-443391",1995,167,98,9.27277191176471,69
"5328","WI-443391",1996,180,106,10.3883789041096,74
"5329","WI-443391",1997,173,104,9.92476,69
"5330","WI-443391",1998,168,82,11.3406058823529,86
"5331","WI-443391",1999,158,85,10.4631066666667,73
"5332","WI-443391",2000,193,78,11.4054471052632,115
"5333","WI-443391",2001,162,89,9.95122791666667,73
"5334","WI-443391",2002,173,97,10.2087406666667,76
"5335","WI-443391",2003,183,98,12.3001147619048,85
"5336","WI-443391",2004,194,82,10.6931133333333,112
"5337","WI-443391",2005,156,85,9.595049,71
"5338","WI-443391",2006,146,86,8.7074793220339,60
"5339","WI-443391",2007,163,101,13.2152655737705,62
"5340","WI-443391",2008,191,91,11.3589270707071,100
"5341","WI-443391",2009,170,90,9.57033506329114,80
"5342","WI-443391",2010,142,66,8.08853826666667,76
"5343","WI-443391",2011,157,90,8.86098848484849,67
"5344","WI-443391",2012,169,68,10.5351698,101
"5345","WI-443391",2013,173,104,11.4355726470588,69
"5346","WI-443391",2014,177,107,12.7767408695652,70
"5347","WI-443391",2015,193,88,12.3574204807692,105
"5348","WI-443391",2016,169,101,12.4612562686567,68
"5349","WI-443391",2017,161,78,9.08984658536585,83
"5350","WI-443391",2018,145,109,11.3056514285714,36
"5351","WI-443391",2019,178,103,11.2877127027027,75
"5352","WI-443391",2020,179,109,12.2674791304348,70
"5353","WI-443391",2021,142,76,7.56167769230769,66
"5354","WI-443391",2022,169,108,12.3449175,61
"5355","WI-443391",2023,151,96,10.2983012962963,55
"5356","WI-493063",1979,189,99,12.3789019101124,90
"5357","WI-493063",1980,144,87,9.4158625,57
"5358","WI-493063",1981,178,78,11.7186496969697,100
"5359","WI-493063",1982,184,100,13.1720851807229,84
"5360","WI-493063",1983,172,107,11.4614921875,65
"5361","WI-493063",1984,172,86,10.5265497647059,86
"5362","WI-493063",1985,184,74,11.7949989908257,110
"5363","WI-493063",1986,149,83,10.1520498461538,66
"5364","WI-493063",1987,149,92,12.97986125,57
"5365","WI-493063",1988,149,83,9.67161692307692,66
"5366","WI-493063",1989,170,100,11.7223066666667,70
"5367","WI-493063",1990,166,85,10.492192125,81
"5368","WI-493063",1991,133,75,7.24182157894737,58
"5369","WI-493063",1992,163,85,9.58758519480519,78
"5370","WI-493063",1993,188,82,11.0098746666667,106
"5371","WI-493063",1994,164,87,10.3458864473684,77
"5372","WI-493063",1995,166,97,10.2376601470588,69
"5373","WI-493063",1996,164,101,9.60648403225806,63
"5374","WI-493063",1997,171,101,11.0068531884058,70
"5375","WI-493063",1998,137,81,10.3821245454545,56
"5376","WI-493063",1999,157,77,10.2425584810127,80
"5377","WI-493063",2000,162,77,10.2575672619048,85
"5378","WI-493063",2001,161,89,10.9696235211268,72
"5379","WI-493063",2002,159,95,9.58682603174603,64
"5380","WI-493063",2003,166,98,12.1230410447761,68
"5381","WI-493063",2004,184,81,11.2676333333333,103
"5382","WI-493063",2005,155,84,10.425939,71
"5383","WI-493063",2006,146,85,9.57156483333333,61
"5384","WI-493063",2007,152,101,13.865566,51
"5385","WI-493063",2008,186,91,11.7172160638298,95
"5386","WI-493063",2009,166,95,11.3371267142857,71
"5387","WI-493063",2010,142,66,8.79895506666667,76
"5388","WI-493063",2011,156,89,9.65767015151515,67
"5389","WI-493063",2012,158,68,11.2633291011236,90
"5390","WI-493063",2013,171,95,10.3384502666667,76
"5391","WI-493063",2014,148,95,8.78566711538462,53
"5392","WI-493063",2015,174,86,12.2130114942529,88
"5393","WI-493063",2016,163,65,9.62972051546392,98
"5394","WI-493063",2017,156,76,9.8014,80
"5395","WI-493063",2018,144,109,12.4718644117647,35
"5396","WI-493063",2019,157,82,8.54096986486486,75
"5397","WI-493063",2020,157,107,11.4185563265306,50
"5398","WI-493063",2021,140,67,7.20326486111111,73
"5399","WI-493063",2022,165,90,10.3345182432432,75
"5400","WI-493063",2023,150,91,10.4849970689655,59
"5401","WI-493080",1979,189,99,12.3789019101124,90
"5402","WI-493080",1980,144,87,9.4158625,57
"5403","WI-493080",1981,178,78,11.7186496969697,100
"5404","WI-493080",1982,184,100,13.1720851807229,84
"5405","WI-493080",1983,172,107,11.4614921875,65
"5406","WI-493080",1984,172,86,10.5265497647059,86
"5407","WI-493080",1985,184,74,11.7949989908257,110
"5408","WI-493080",1986,149,83,10.1520498461538,66
"5409","WI-493080",1987,149,92,12.97986125,57
"5410","WI-493080",1988,149,83,9.67161692307692,66
"5411","WI-493080",1989,170,100,11.7223066666667,70
"5412","WI-493080",1990,166,85,10.492192125,81
"5413","WI-493080",1991,133,75,7.24182157894737,58
"5414","WI-493080",1992,163,85,9.58758519480519,78
"5415","WI-493080",1993,188,82,11.0098746666667,106
"5416","WI-493080",1994,164,87,10.3458864473684,77
"5417","WI-493080",1995,166,97,10.2376601470588,69
"5418","WI-493080",1996,164,101,9.60648403225806,63
"5419","WI-493080",1997,171,101,11.0068531884058,70
"5420","WI-493080",1998,137,81,10.3821245454545,56
"5421","WI-493080",1999,157,77,10.2425584810127,80
"5422","WI-493080",2000,162,77,10.2575672619048,85
"5423","WI-493080",2001,161,89,10.9696235211268,72
"5424","WI-493080",2002,159,95,9.58682603174603,64
"5425","WI-493080",2003,166,98,12.1230410447761,68
"5426","WI-493080",2004,184,81,11.2676333333333,103
"5427","WI-493080",2005,155,84,10.425939,71
"5428","WI-493080",2006,146,85,9.57156483333333,61
"5429","WI-493080",2007,152,101,13.865566,51
"5430","WI-493080",2008,186,91,11.7172160638298,95
"5431","WI-493080",2009,166,95,11.3371267142857,71
"5432","WI-493080",2010,142,66,8.79895506666667,76
"5433","WI-493080",2011,156,89,9.65767015151515,67
"5434","WI-493080",2012,158,68,11.2633291011236,90
"5435","WI-493080",2013,171,95,10.3384502666667,76
"5436","WI-493080",2014,148,95,8.78566711538462,53
"5437","WI-493080",2015,174,86,12.2130114942529,88
"5438","WI-493080",2016,163,65,9.62972051546392,98
"5439","WI-493080",2017,156,76,9.8014,80
"5440","WI-493080",2018,144,109,12.4718644117647,35
"5441","WI-493080",2019,157,82,8.54096986486486,75
"5442","WI-493080",2020,157,107,11.4185563265306,50
"5443","WI-493080",2021,140,67,7.20326486111111,73
"5444","WI-493080",2022,165,90,10.3345182432432,75
"5445","WI-493080",2023,150,91,10.4849970689655,59
"5446","WI-493097",1979,189,100,12.51541375,89
"5447","WI-493097",1980,145,87,9.28590070175439,58
"5448","WI-493097",1981,178,79,11.6143573469388,99
"5449","WI-493097",1982,184,101,13.2350707317073,83
"5450","WI-493097",1983,172,107,11.348820625,65
"5451","WI-493097",1984,172,84,10.3310493103448,88
"5452","WI-493097",1985,184,74,11.8018085321101,110
"5453","WI-493097",1986,149,83,10.1959201538462,66
"5454","WI-493097",1987,149,92,12.5865855357143,57
"5455","WI-493097",1988,150,84,9.64905338461539,66
"5456","WI-493097",1989,170,100,11.6787156521739,70
"5457","WI-493097",1990,166,86,10.3767913924051,80
"5458","WI-493097",1991,133,75,7.17589473684211,58
"5459","WI-493097",1992,164,85,9.50767064102564,79
"5460","WI-493097",1993,186,83,10.7091218627451,103
"5461","WI-493097",1994,165,88,10.2684128947368,77
"5462","WI-493097",1995,166,98,10.2314525373134,68
"5463","WI-493097",1996,165,102,9.67561629032258,63
"5464","WI-493097",1997,171,101,10.7258295652174,70
"5465","WI-493097",1998,166,81,11.9392289285714,85
"5466","WI-493097",1999,157,76,10.09933525,81
"5467","WI-493097",2000,185,77,11.7272904672897,108
"5468","WI-493097",2001,162,89,10.8775515277778,73
"5469","WI-493097",2002,160,96,9.8134080952381,64
"5470","WI-493097",2003,166,98,12.0070205970149,68
"5471","WI-493097",2004,193,81,11.8449085585586,112
"5472","WI-493097",2005,155,84,10.2520555714286,71
"5473","WI-493097",2006,146,85,9.36297066666667,61
"5474","WI-493097",2007,152,101,13.6579102,51
"5475","WI-493097",2008,186,91,11.7635920212766,95
"5476","WI-493097",2009,167,91,10.5807416,76
"5477","WI-493097",2010,142,66,8.7559348,76
"5478","WI-493097",2011,156,89,9.61067727272727,67
"5479","WI-493097",2012,159,68,11.5319678888889,91
"5480","WI-493097",2013,171,95,10.4061585333333,76
"5481","WI-493097",2014,148,95,8.53371442307692,53
"5482","WI-493097",2015,175,86,12.1350727272727,89
"5483","WI-493097",2016,163,98,12.4323303125,65
"5484","WI-493097",2017,157,77,9.7754617721519,80
"5485","WI-493097",2018,144,109,12.1598247058824,35
"5486","WI-493097",2019,177,82,10.3884937234043,95
"5487","WI-493097",2020,157,107,11.1714271428571,50
"5488","WI-493097",2021,141,67,7.29728219178082,74
"5489","WI-493097",2022,165,90,10.2784587837838,75
"5490","WI-493097",2023,150,91,10.3722544827586,59
"5491","WI-493103",1979,189,99,12.3789019101124,90
"5492","WI-493103",1980,144,87,9.4158625,57
"5493","WI-493103",1981,178,78,11.7186496969697,100
"5494","WI-493103",1982,184,100,13.1720851807229,84
"5495","WI-493103",1983,172,107,11.4614921875,65
"5496","WI-493103",1984,172,86,10.5265497647059,86
"5497","WI-493103",1985,184,74,11.7949989908257,110
"5498","WI-493103",1986,149,83,10.1520498461538,66
"5499","WI-493103",1987,149,92,12.97986125,57
"5500","WI-493103",1988,149,83,9.67161692307692,66
"5501","WI-493103",1989,170,100,11.7223066666667,70
"5502","WI-493103",1990,166,85,10.492192125,81
"5503","WI-493103",1991,133,75,7.24182157894737,58
"5504","WI-493103",1992,163,85,9.58758519480519,78
"5505","WI-493103",1993,188,82,11.0098746666667,106
"5506","WI-493103",1994,164,87,10.3458864473684,77
"5507","WI-493103",1995,166,97,10.2376601470588,69
"5508","WI-493103",1996,164,101,9.60648403225806,63
"5509","WI-493103",1997,171,101,11.0068531884058,70
"5510","WI-493103",1998,137,81,10.3821245454545,56
"5511","WI-493103",1999,157,77,10.2425584810127,80
"5512","WI-493103",2000,162,77,10.2575672619048,85
"5513","WI-493103",2001,161,89,10.9696235211268,72
"5514","WI-493103",2002,159,95,9.58682603174603,64
"5515","WI-493103",2003,166,98,12.1230410447761,68
"5516","WI-493103",2004,184,81,11.2676333333333,103
"5517","WI-493103",2005,155,84,10.425939,71
"5518","WI-493103",2006,146,85,9.57156483333333,61
"5519","WI-493103",2007,152,101,13.865566,51
"5520","WI-493103",2008,186,91,11.7172160638298,95
"5521","WI-493103",2009,166,95,11.3371267142857,71
"5522","WI-493103",2010,142,66,8.79895506666667,76
"5523","WI-493103",2011,156,89,9.65767015151515,67
"5524","WI-493103",2012,158,68,11.2633291011236,90
"5525","WI-493103",2013,171,95,10.3384502666667,76
"5526","WI-493103",2014,148,95,8.78566711538462,53
"5527","WI-493103",2015,174,86,12.2130114942529,88
"5528","WI-493103",2016,163,65,9.62972051546392,98
"5529","WI-493103",2017,156,76,9.8014,80
"5530","WI-493103",2018,144,109,12.4718644117647,35
"5531","WI-493103",2019,157,82,8.54096986486486,75
"5532","WI-493103",2020,157,107,11.4185563265306,50
"5533","WI-493103",2021,140,67,7.20326486111111,73
"5534","WI-493103",2022,165,90,10.3345182432432,75
"5535","WI-493103",2023,150,91,10.4849970689655,59
"5536","WI-493105",1979,189,100,12.51541375,89
"5537","WI-493105",1980,145,87,9.28590070175439,58
"5538","WI-493105",1981,178,79,11.6143573469388,99
"5539","WI-493105",1982,184,101,13.2350707317073,83
"5540","WI-493105",1983,172,107,11.348820625,65
"5541","WI-493105",1984,172,84,10.3310493103448,88
"5542","WI-493105",1985,184,74,11.8018085321101,110
"5543","WI-493105",1986,149,83,10.1959201538462,66
"5544","WI-493105",1987,149,92,12.5865855357143,57
"5545","WI-493105",1988,150,84,9.64905338461539,66
"5546","WI-493105",1989,170,100,11.6787156521739,70
"5547","WI-493105",1990,166,86,10.3767913924051,80
"5548","WI-493105",1991,133,75,7.17589473684211,58
"5549","WI-493105",1992,164,85,9.50767064102564,79
"5550","WI-493105",1993,186,83,10.7091218627451,103
"5551","WI-493105",1994,165,88,10.2684128947368,77
"5552","WI-493105",1995,166,98,10.2314525373134,68
"5553","WI-493105",1996,165,102,9.67561629032258,63
"5554","WI-493105",1997,171,101,10.7258295652174,70
"5555","WI-493105",1998,166,81,11.9392289285714,85
"5556","WI-493105",1999,157,76,10.09933525,81
"5557","WI-493105",2000,185,77,11.7272904672897,108
"5558","WI-493105",2001,162,89,10.8775515277778,73
"5559","WI-493105",2002,160,96,9.8134080952381,64
"5560","WI-493105",2003,166,98,12.0070205970149,68
"5561","WI-493105",2004,193,81,11.8449085585586,112
"5562","WI-493105",2005,155,84,10.2520555714286,71
"5563","WI-493105",2006,146,85,9.36297066666667,61
"5564","WI-493105",2007,152,101,13.6579102,51
"5565","WI-493105",2008,186,91,11.7635920212766,95
"5566","WI-493105",2009,167,91,10.5807416,76
"5567","WI-493105",2010,142,66,8.7559348,76
"5568","WI-493105",2011,156,89,9.61067727272727,67
"5569","WI-493105",2012,159,68,11.5319678888889,91
"5570","WI-493105",2013,171,95,10.4061585333333,76
"5571","WI-493105",2014,148,95,8.53371442307692,53
"5572","WI-493105",2015,175,86,12.1350727272727,89
"5573","WI-493105",2016,163,98,12.4323303125,65
"5574","WI-493105",2017,157,77,9.7754617721519,80
"5575","WI-493105",2018,144,109,12.1598247058824,35
"5576","WI-493105",2019,177,82,10.3884937234043,95
"5577","WI-493105",2020,157,107,11.1714271428571,50
"5578","WI-493105",2021,141,67,7.29728219178082,74
"5579","WI-493105",2022,165,90,10.2784587837838,75
"5580","WI-493105",2023,150,91,10.3722544827586,59
"5581","WI-493122",1979,189,99,12.5880837078652,90
"5582","WI-493122",1980,145,86,9.36380224137931,59
"5583","WI-493122",1981,163,78,10.6820335714286,85
"5584","WI-493122",1982,184,100,13.2205603614458,84
"5585","WI-493122",1983,162,108,10.3317494339623,54
"5586","WI-493122",1984,172,86,10.5836267058824,86
"5587","WI-493122",1985,184,74,11.9827857798165,110
"5588","WI-493122",1986,149,83,10.3287323076923,66
"5589","WI-493122",1987,149,92,12.93466125,57
"5590","WI-493122",1988,149,83,9.67341969230769,66
"5591","WI-493122",1989,170,100,11.8209243478261,70
"5592","WI-493122",1990,165,85,10.3920865822785,80
"5593","WI-493122",1991,133,75,7.39258912280702,58
"5594","WI-493122",1992,163,85,9.60767441558442,78
"5595","WI-493122",1993,186,82,10.8532568932039,104
"5596","WI-493122",1994,164,87,10.3742581578947,77
"5597","WI-493122",1995,166,97,10.3307202941176,69
"5598","WI-493122",1996,164,101,9.66343935483871,63
"5599","WI-493122",1997,171,101,11.0225913043478,70
"5600","WI-493122",1998,137,81,10.4834030909091,56
"5601","WI-493122",1999,157,76,10.197187625,81
"5602","WI-493122",2000,162,76,10.1768808235294,86
"5603","WI-493122",2001,161,89,10.9921804225352,72
"5604","WI-493122",2002,159,95,9.75187968253968,64
"5605","WI-493122",2003,166,98,12.1701492537313,68
"5606","WI-493122",2004,184,81,11.4769619607843,103
"5607","WI-493122",2005,155,84,10.4528365714286,71
"5608","WI-493122",2006,146,85,9.5312,61
"5609","WI-493122",2007,152,101,13.8219732,51
"5610","WI-493122",2008,186,91,11.8726343617021,95
"5611","WI-493122",2009,167,90,10.8613771052632,77
"5612","WI-493122",2010,142,66,8.89155853333333,76
"5613","WI-493122",2011,156,89,9.72691742424242,67
"5614","WI-493122",2012,158,68,11.4435434831461,90
"5615","WI-493122",2013,171,95,10.4826168,76
"5616","WI-493122",2014,148,94,8.69152320754717,54
"5617","WI-493122",2015,175,86,12.2657548863636,89
"5618","WI-493122",2016,163,65,9.66958917525773,98
"5619","WI-493122",2017,156,76,9.75749063291139,80
"5620","WI-493122",2018,144,109,12.4036205882353,35
"5621","WI-493122",2019,157,82,8.64274391891892,75
"5622","WI-493122",2020,156,107,11.225823125,49
"5623","WI-493122",2021,140,66,7.30838917808219,74
"5624","WI-493122",2022,164,90,10.3255339726027,74
"5625","WI-493122",2023,150,91,10.6099972413793,59
"5626","WI-493126",1979,189,99,12.3789019101124,90
"5627","WI-493126",1980,144,87,9.4158625,57
"5628","WI-493126",1981,178,78,11.7186496969697,100
"5629","WI-493126",1982,184,100,13.1720851807229,84
"5630","WI-493126",1983,172,107,11.4614921875,65
"5631","WI-493126",1984,172,86,10.5265497647059,86
"5632","WI-493126",1985,184,74,11.7949989908257,110
"5633","WI-493126",1986,149,83,10.1520498461538,66
"5634","WI-493126",1987,149,92,12.97986125,57
"5635","WI-493126",1988,149,83,9.67161692307692,66
"5636","WI-493126",1989,170,100,11.7223066666667,70
"5637","WI-493126",1990,166,85,10.492192125,81
"5638","WI-493126",1991,133,75,7.24182157894737,58
"5639","WI-493126",1992,163,85,9.58758519480519,78
"5640","WI-493126",1993,188,82,11.0098746666667,106
"5641","WI-493126",1994,164,87,10.3458864473684,77
"5642","WI-493126",1995,166,97,10.2376601470588,69
"5643","WI-493126",1996,164,101,9.60648403225806,63
"5644","WI-493126",1997,171,101,11.0068531884058,70
"5645","WI-493126",1998,137,81,10.3821245454545,56
"5646","WI-493126",1999,157,77,10.2425584810127,80
"5647","WI-493126",2000,162,77,10.2575672619048,85
"5648","WI-493126",2001,161,89,10.9696235211268,72
"5649","WI-493126",2002,159,95,9.58682603174603,64
"5650","WI-493126",2003,166,98,12.1230410447761,68
"5651","WI-493126",2004,184,81,11.2676333333333,103
"5652","WI-493126",2005,155,84,10.425939,71
"5653","WI-493126",2006,146,85,9.57156483333333,61
"5654","WI-493126",2007,152,101,13.865566,51
"5655","WI-493126",2008,186,91,11.7172160638298,95
"5656","WI-493126",2009,166,95,11.3371267142857,71
"5657","WI-493126",2010,142,66,8.79895506666667,76
"5658","WI-493126",2011,156,89,9.65767015151515,67
"5659","WI-493126",2012,158,68,11.2633291011236,90
"5660","WI-493126",2013,171,95,10.3384502666667,76
"5661","WI-493126",2014,148,95,8.78566711538462,53
"5662","WI-493126",2015,174,86,12.2130114942529,88
"5663","WI-493126",2016,163,65,9.62972051546392,98
"5664","WI-493126",2017,156,76,9.8014,80
"5665","WI-493126",2018,144,109,12.4718644117647,35
"5666","WI-493126",2019,157,82,8.54096986486486,75
"5667","WI-493126",2020,157,107,11.4185563265306,50
"5668","WI-493126",2021,140,67,7.20326486111111,73
"5669","WI-493126",2022,165,90,10.3345182432432,75
"5670","WI-493126",2023,150,91,10.4849970689655,59
"5671","WI-493131",1979,189,99,12.5880837078652,90
"5672","WI-493131",1980,145,86,9.36380224137931,59
"5673","WI-493131",1981,163,78,10.6820335714286,85
"5674","WI-493131",1982,184,100,13.2205603614458,84
"5675","WI-493131",1983,162,108,10.3317494339623,54
"5676","WI-493131",1984,172,86,10.5836267058824,86
"5677","WI-493131",1985,184,74,11.9827857798165,110
"5678","WI-493131",1986,149,83,10.3287323076923,66
"5679","WI-493131",1987,149,92,12.93466125,57
"5680","WI-493131",1988,149,83,9.67341969230769,66
"5681","WI-493131",1989,170,100,11.8209243478261,70
"5682","WI-493131",1990,165,85,10.3920865822785,80
"5683","WI-493131",1991,133,75,7.39258912280702,58
"5684","WI-493131",1992,163,85,9.60767441558442,78
"5685","WI-493131",1993,186,82,10.8532568932039,104
"5686","WI-493131",1994,164,87,10.3742581578947,77
"5687","WI-493131",1995,166,97,10.3307202941176,69
"5688","WI-493131",1996,164,101,9.66343935483871,63
"5689","WI-493131",1997,171,101,11.0225913043478,70
"5690","WI-493131",1998,137,81,10.4834030909091,56
"5691","WI-493131",1999,157,76,10.197187625,81
"5692","WI-493131",2000,162,76,10.1768808235294,86
"5693","WI-493131",2001,161,89,10.9921804225352,72
"5694","WI-493131",2002,159,95,9.75187968253968,64
"5695","WI-493131",2003,166,98,12.1701492537313,68
"5696","WI-493131",2004,184,81,11.4769619607843,103
"5697","WI-493131",2005,155,84,10.4528365714286,71
"5698","WI-493131",2006,146,85,9.5312,61
"5699","WI-493131",2007,152,101,13.8219732,51
"5700","WI-493131",2008,186,91,11.8726343617021,95
"5701","WI-493131",2009,167,90,10.8613771052632,77
"5702","WI-493131",2010,142,66,8.89155853333333,76
"5703","WI-493131",2011,156,89,9.72691742424242,67
"5704","WI-493131",2012,158,68,11.4435434831461,90
"5705","WI-493131",2013,171,95,10.4826168,76
"5706","WI-493131",2014,148,94,8.69152320754717,54
"5707","WI-493131",2015,175,86,12.2657548863636,89
"5708","WI-493131",2016,163,65,9.66958917525773,98
"5709","WI-493131",2017,156,76,9.75749063291139,80
"5710","WI-493131",2018,144,109,12.4036205882353,35
"5711","WI-493131",2019,157,82,8.64274391891892,75
"5712","WI-493131",2020,156,107,11.225823125,49
"5713","WI-493131",2021,140,66,7.30838917808219,74
"5714","WI-493131",2022,164,90,10.3255339726027,74
"5715","WI-493131",2023,150,91,10.6099972413793,59
"5716","WI-503139",1979,189,100,12.7663017045455,89
"5717","WI-503139",1980,175,87,11.5790273563218,88
"5718","WI-503139",1981,182,80,11.7061756435644,102
"5719","WI-503139",1982,184,101,13.1243624390244,83
"5720","WI-503139",1983,163,108,10.2172161111111,55
"5721","WI-503139",1984,193,87,11.9254291428571,106
"5722","WI-503139",1985,180,77,11.651722254902,103
"5723","WI-503139",1986,185,83,12.7875305940594,102
"5724","WI-503139",1987,149,92,11.8978308928571,57
"5725","WI-503139",1988,150,83,9.18839439393939,67
"5726","WI-503139",1989,171,100,11.7331025714286,71
"5727","WI-503139",1990,166,86,10.2770089873418,80
"5728","WI-503139",1991,133,75,7.21098263157895,58
"5729","WI-503139",1992,234,85,13.0669018918919,149
"5730","WI-503139",1993,186,81,10.50466375,105
"5731","WI-503139",1994,164,86,9.83051844155844,78
"5732","WI-503139",1995,167,97,10.3889104347826,70
"5733","WI-503139",1996,179,102,10.8209644736842,77
"5734","WI-503139",1997,172,101,10.5235241428571,71
"5735","WI-503139",1998,136,81,10.0821583333333,55
"5736","WI-503139",1999,157,75,10.182472345679,82
"5737","WI-503139",2000,185,52,10.4118458333333,133
"5738","WI-503139",2001,162,88,10.8965819178082,74
"5739","WI-503139",2002,161,96,10.1328321875,65
"5740","WI-503139",2003,173,97,12.1952858666667,76
"5741","WI-503139",2004,193,81,11.9963022522523,112
"5742","WI-503139",2005,155,83,10.0354107042254,72
"5743","WI-503139",2006,146,84,9.3996606557377,62
"5744","WI-503139",2007,152,100,12.8368115686275,52
"5745","WI-503139",2008,187,87,11.8357446464646,100
"5746","WI-503139",2009,169,74,9.16572882978723,95
"5747","WI-503139",2010,143,65,8.69148454545455,78
"5748","WI-503139",2011,156,89,9.56036939393939,67
"5749","WI-503139",2012,168,67,12.0279439,101
"5750","WI-503139",2013,173,94,11.2460643589744,79
"5751","WI-503139",2014,170,88,10.8626744444444,82
"5752","WI-503139",2015,191,86,13.0302855769231,105
"5753","WI-503139",2016,146,98,10.04649,48
"5754","WI-503139",2017,160,76,9.95285638554217,84
"5755","WI-503139",2018,145,108,12.1527938888889,37
"5756","WI-503139",2019,177,82,10.3559137234043,95
"5757","WI-503139",2020,171,81,9.67225808988764,90
"5758","WI-503139",2021,141,66,7.63493540540541,75
"5759","WI-503139",2022,131,90,5.93785625,41
"5760","WI-503139",2023,150,89,10.2546953333333,61
"5761","WI-503140",1979,189,99,13.0053071910112,90
"5762","WI-503140",1980,175,86,11.7538171590909,89
"5763","WI-503140",1981,163,80,10.5567703658537,83
"5764","WI-503140",1982,184,100,13.2934145783133,84
"5765","WI-503140",1983,162,108,10.3173043396226,54
"5766","WI-503140",1984,157,86,8.65387928571429,71
"5767","WI-503140",1985,180,74,11.618086,106
"5768","WI-503140",1986,149,83,10.3776506153846,66
"5769","WI-503140",1987,149,92,12.18173125,57
"5770","WI-503140",1988,150,83,9.44833803030303,67
"5771","WI-503140",1989,171,100,12.026295,71
"5772","WI-503140",1990,165,85,10.2244637974684,80
"5773","WI-503140",1991,133,75,7.47715543859649,58
"5774","WI-503140",1992,164,85,9.72351615384615,79
"5775","WI-503140",1993,186,81,10.7847872115385,105
"5776","WI-503140",1994,164,77,9.28265523255814,87
"5777","WI-503140",1995,155,97,9.29461842105263,58
"5778","WI-503140",1996,179,101,11.1392805194805,78
"5779","WI-503140",1997,171,101,10.7128089855072,70
"5780","WI-503140",1998,136,81,10.3670257407407,55
"5781","WI-503140",1999,156,75,10.290063375,81
"5782","WI-503140",2000,163,52,9.11996927272727,111
"5783","WI-503140",2001,161,88,10.990785,73
"5784","WI-503140",2002,160,95,10.07237859375,65
"5785","WI-503140",2003,167,97,11.9701953623188,70
"5786","WI-503140",2004,159,81,10.1752501298701,78
"5787","WI-503140",2005,155,83,10.2804591549296,72
"5788","WI-503140",2006,146,85,9.65945466666667,61
"5789","WI-503140",2007,151,100,13.0715648,51
"5790","WI-503140",2008,187,86,11.9449327,101
"5791","WI-503140",2009,169,73,9.34417,96
"5792","WI-503140",2010,142,65,8.81027723684211,77
"5793","WI-503140",2011,155,89,9.62240569230769,66
"5794","WI-503140",2012,160,67,11.8207872826087,93
"5795","WI-503140",2013,172,94,11.327752987013,78
"5796","WI-503140",2014,168,88,10.7888482278481,80
"5797","WI-503140",2015,175,86,12.2521715909091,89
"5798","WI-503140",2016,145,97,9.98298893617021,48
"5799","WI-503140",2017,159,76,10.0944269512195,83
"5800","WI-503140",2018,144,108,12.07641,36
"5801","WI-503140",2019,176,82,10.6498750537634,94
"5802","WI-503140",2020,146,80,6.64449584615385,66
"5803","WI-503140",2021,140,66,7.68328178082192,74
"5804","WI-503140",2022,131,90,6.26246475,41
"5805","WI-503140",2023,150,80,9.18565724637681,70
"5806","WI-513088",1979,190,101,10.6416647727273,89
"5807","WI-513088",1980,175,104,12.6522078571429,71
"5808","WI-513088",1981,185,81,10.7029791262136,104
"5809","WI-513088",1982,185,101,12.045894939759,84
"5810","WI-513088",1983,173,109,10.6404741269841,64
"5811","WI-513088",1984,193,93,11.3982481818182,100
"5812","WI-513088",1985,218,98,14.541781092437,120
"5813","WI-513088",1986,187,84,11.8871200980392,103
"5814","WI-513088",1987,150,93,11.5313644642857,57
"5815","WI-513088",1988,150,85,8.52513359375,65
"5816","WI-513088",1989,172,102,10.9047391304348,70
"5817","WI-513088",1990,178,99,11.8287764102564,79
"5818","WI-513088",1991,133,90,7.63095761904762,43
"5819","WI-513088",1992,NA,105,NA,NA
"5820","WI-513088",1993,222,94,12.5395005511811,128
"5821","WI-513088",1994,165,95,9.83455753623188,70
"5822","WI-513088",1995,167,98,9.22233617647059,69
"5823","WI-513088",1996,180,106,10.4494876712329,74
"5824","WI-513088",1997,173,104,9.92786205882353,69
"5825","WI-513088",1998,168,82,11.2066907058824,86
"5826","WI-513088",1999,158,85,10.4011490277778,73
"5827","WI-513088",2000,193,78,11.2454963157895,115
"5828","WI-513088",2001,162,89,9.73801194444444,73
"5829","WI-513088",2002,173,97,10.1762421333333,76
"5830","WI-513088",2003,183,98,12.2747232142857,85
"5831","WI-513088",2004,194,82,10.6791773873874,112
"5832","WI-513088",2005,157,85,9.64741154929578,72
"5833","WI-513088",2006,146,86,8.65663254237288,60
"5834","WI-513088",2007,163,101,13.1663427868852,62
"5835","WI-513088",2008,191,92,11.3634654081633,99
"5836","WI-513088",2009,169,98,10.5030171428571,71
"5837","WI-513088",2010,142,66,7.93916333333333,76
"5838","WI-513088",2011,179,90,10.7102248863636,89
"5839","WI-513088",2012,169,68,10.4832946,101
"5840","WI-513088",2013,173,108,11.8305928125,65
"5841","WI-513088",2014,172,107,12.27686890625,65
"5842","WI-513088",2015,192,87,12.1686739423077,105
"5843","WI-513088",2016,169,101,12.4797970149254,68
"5844","WI-513088",2017,161,79,9.07610691358025,82
"5845","WI-513088",2018,145,109,11.3440431428571,36
"5846","WI-513088",2019,178,103,11.2838067567568,75
"5847","WI-513088",2020,179,109,12.3313379710145,70
"5848","WI-513088",2021,142,75,7.28539878787879,67
"5849","WI-513088",2022,168,108,12.2505762711864,60
"5850","WI-513088",2023,151,96,10.0864955555556,55
"5851","WI-513095",1979,190,122,8.6590623880597,68
"5852","WI-513095",1980,175,106,11.0088302941176,69
"5853","WI-513095",1981,185,95,10.887822247191,90
"5854","WI-513095",1982,185,102,12.1575462195122,83
"5855","WI-513095",1983,173,109,10.4955087301587,64
"5856","WI-513095",1984,193,101,11.1600013186813,92
"5857","WI-513095",1985,218,98,14.3910457983193,120
"5858","WI-513095",1986,187,86,11.8441623,101
"5859","WI-513095",1987,150,93,11.4404051785714,57
"5860","WI-513095",1988,150,86,8.44087063492064,64
"5861","WI-513095",1989,173,102,10.8133124285714,71
"5862","WI-513095",1990,179,99,11.7368237974684,80
"5863","WI-513095",1991,151,91,10.7587662711864,60
"5864","WI-513095",1992,NA,105,NA,NA
"5865","WI-513095",1993,222,94,12.3697165354331,128
"5866","WI-513095",1994,165,95,9.64943579710145,70
"5867","WI-513095",1995,167,98,9.07504720588235,69
"5868","WI-513095",1996,181,106,10.41944,75
"5869","WI-513095",1997,173,104,9.77459911764706,69
"5870","WI-513095",1998,169,82,11.2486558139535,87
"5871","WI-513095",1999,158,85,10.2323115277778,73
"5872","WI-513095",2000,193,78,11.1809405263158,115
"5873","WI-513095",2001,163,89,9.92762178082192,74
"5874","WI-513095",2002,173,97,9.98790786666667,76
"5875","WI-513095",2003,183,98,12.1720444047619,85
"5876","WI-513095",2004,194,93,11.192073,101
"5877","WI-513095",2005,157,85,9.62826464788732,72
"5878","WI-513095",2006,147,86,8.765628,61
"5879","WI-513095",2007,163,101,13.0795072131148,62
"5880","WI-513095",2008,191,92,11.2620621428571,99
"5881","WI-513095",2009,170,98,10.4287438028169,72
"5882","WI-513095",2010,142,66,7.95447573333333,76
"5883","WI-513095",2011,180,90,10.6927458426966,90
"5884","WI-513095",2012,169,69,10.4837593939394,100
"5885","WI-513095",2013,173,108,11.7973890625,65
"5886","WI-513095",2014,177,107,12.605091884058,70
"5887","WI-513095",2015,193,88,12.2332463461538,105
"5888","WI-513095",2016,188,101,13.6859224418605,87
"5889","WI-513095",2017,161,78,8.90568109756098,83
"5890","WI-513095",2018,145,109,11.0960525714286,36
"5891","WI-513095",2019,178,103,11.0351794594595,75
"5892","WI-513095",2020,179,109,12.1350063768116,70
"5893","WI-513095",2021,155,76,8.5075958974359,79
"5894","WI-513095",2022,169,108,12.1270781666667,61
"5895","WI-513095",2023,151,96,10.0972024074074,55
"5896","WI-513126",1979,190,122,8.6590623880597,68
"5897","WI-513126",1980,175,106,11.0088302941176,69
"5898","WI-513126",1981,185,95,10.887822247191,90
"5899","WI-513126",1982,185,102,12.1575462195122,83
"5900","WI-513126",1983,173,109,10.4955087301587,64
"5901","WI-513126",1984,193,101,11.1600013186813,92
"5902","WI-513126",1985,218,98,14.3910457983193,120
"5903","WI-513126",1986,187,86,11.8441623,101
"5904","WI-513126",1987,150,93,11.4404051785714,57
"5905","WI-513126",1988,150,86,8.44087063492064,64
"5906","WI-513126",1989,173,102,10.8133124285714,71
"5907","WI-513126",1990,179,99,11.7368237974684,80
"5908","WI-513126",1991,151,91,10.7587662711864,60
"5909","WI-513126",1992,NA,105,NA,NA
"5910","WI-513126",1993,222,94,12.3697165354331,128
"5911","WI-513126",1994,165,95,9.64943579710145,70
"5912","WI-513126",1995,167,98,9.07504720588235,69
"5913","WI-513126",1996,181,106,10.41944,75
"5914","WI-513126",1997,173,104,9.77459911764706,69
"5915","WI-513126",1998,169,82,11.2486558139535,87
"5916","WI-513126",1999,158,85,10.2323115277778,73
"5917","WI-513126",2000,193,78,11.1809405263158,115
"5918","WI-513126",2001,163,89,9.92762178082192,74
"5919","WI-513126",2002,173,97,9.98790786666667,76
"5920","WI-513126",2003,183,98,12.1720444047619,85
"5921","WI-513126",2004,194,93,11.192073,101
"5922","WI-513126",2005,157,85,9.62826464788732,72
"5923","WI-513126",2006,147,86,8.765628,61
"5924","WI-513126",2007,163,101,13.0795072131148,62
"5925","WI-513126",2008,191,92,11.2620621428571,99
"5926","WI-513126",2009,170,98,10.4287438028169,72
"5927","WI-513126",2010,142,66,7.95447573333333,76
"5928","WI-513126",2011,180,90,10.6927458426966,90
"5929","WI-513126",2012,169,69,10.4837593939394,100
"5930","WI-513126",2013,173,108,11.7973890625,65
"5931","WI-513126",2014,177,107,12.605091884058,70
"5932","WI-513126",2015,193,88,12.2332463461538,105
"5933","WI-513126",2016,188,101,13.6859224418605,87
"5934","WI-513126",2017,161,78,8.90568109756098,83
"5935","WI-513126",2018,145,109,11.0960525714286,36
"5936","WI-513126",2019,178,103,11.0351794594595,75
"5937","WI-513126",2020,179,109,12.1350063768116,70
"5938","WI-513126",2021,155,76,8.5075958974359,79
"5939","WI-513126",2022,169,108,12.1270781666667,61
"5940","WI-513126",2023,151,96,10.0972024074074,55
"5941","WI-513133",1979,190,122,8.6590623880597,68
"5942","WI-513133",1980,175,106,11.0088302941176,69
"5943","WI-513133",1981,185,95,10.887822247191,90
"5944","WI-513133",1982,185,102,12.1575462195122,83
"5945","WI-513133",1983,173,109,10.4955087301587,64
"5946","WI-513133",1984,193,101,11.1600013186813,92
"5947","WI-513133",1985,218,98,14.3910457983193,120
"5948","WI-513133",1986,187,86,11.8441623,101
"5949","WI-513133",1987,150,93,11.4404051785714,57
"5950","WI-513133",1988,150,86,8.44087063492064,64
"5951","WI-513133",1989,173,102,10.8133124285714,71
"5952","WI-513133",1990,179,99,11.7368237974684,80
"5953","WI-513133",1991,151,91,10.7587662711864,60
"5954","WI-513133",1992,NA,105,NA,NA
"5955","WI-513133",1993,222,94,12.3697165354331,128
"5956","WI-513133",1994,165,95,9.64943579710145,70
"5957","WI-513133",1995,167,98,9.07504720588235,69
"5958","WI-513133",1996,181,106,10.41944,75
"5959","WI-513133",1997,173,104,9.77459911764706,69
"5960","WI-513133",1998,169,82,11.2486558139535,87
"5961","WI-513133",1999,158,85,10.2323115277778,73
"5962","WI-513133",2000,193,78,11.1809405263158,115
"5963","WI-513133",2001,163,89,9.92762178082192,74
"5964","WI-513133",2002,173,97,9.98790786666667,76
"5965","WI-513133",2003,183,98,12.1720444047619,85
"5966","WI-513133",2004,194,93,11.192073,101
"5967","WI-513133",2005,157,85,9.62826464788732,72
"5968","WI-513133",2006,147,86,8.765628,61
"5969","WI-513133",2007,163,101,13.0795072131148,62
"5970","WI-513133",2008,191,92,11.2620621428571,99
"5971","WI-513133",2009,170,98,10.4287438028169,72
"5972","WI-513133",2010,142,66,7.95447573333333,76
"5973","WI-513133",2011,180,90,10.6927458426966,90
"5974","WI-513133",2012,169,69,10.4837593939394,100
"5975","WI-513133",2013,173,108,11.7973890625,65
"5976","WI-513133",2014,177,107,12.605091884058,70
"5977","WI-513133",2015,193,88,12.2332463461538,105
"5978","WI-513133",2016,188,101,13.6859224418605,87
"5979","WI-513133",2017,161,78,8.90568109756098,83
"5980","WI-513133",2018,145,109,11.0960525714286,36
"5981","WI-513133",2019,178,103,11.0351794594595,75
"5982","WI-513133",2020,179,109,12.1350063768116,70
"5983","WI-513133",2021,155,76,8.5075958974359,79
"5984","WI-513133",2022,169,108,12.1270781666667,61
"5985","WI-513133",2023,151,96,10.0972024074074,55
"5986","WI-523120",1979,157,99,11.8174952631579,58
"5987","WI-523120",1980,152,84,10.2723188059701,68
"5988","WI-523120",1981,156,82,9.30335273972603,74
"5989","WI-523120",1982,133,101,11.1176106451613,32
"5990","WI-523120",1983,161,110,10.8707518,51
"5991","WI-523120",1984,156,92,9.74060095238095,64
"5992","WI-523120",1985,175,81,13.1694209677419,94
"5993","WI-523120",1986,169,83,12.7355427058824,86
"5994","WI-523120",1987,148,92,12.206278,56
"5995","WI-523120",1988,150,80,9.70924173913044,70
"5996","WI-523120",1989,153,81,10.4501801408451,72
"5997","WI-523120",1990,162,85,10.7824503947368,77
"5998","WI-523120",1991,132,74,8.96133631578947,58
"5999","WI-523120",1992,165,84,10.533390875,81
"6000","WI-523120",1993,162,80,9.98785740740741,82
"6001","WI-523120",1994,163,76,10.1294570930233,87
"6002","WI-523120",1995,166,68,9.3963312371134,98
"6003","WI-523120",1996,166,98,10.8028947761194,68
"6004","WI-523120",1997,169,101,11.2600752238806,68
"6005","WI-523120",1998,135,80,10.6308257407407,55
"6006","WI-523120",1999,155,75,10.9054858227848,80
"6007","WI-523120",2000,127,51,7.7821004,76
"6008","WI-523120",2001,161,87,12.2461049315068,74
"6009","WI-523120",2002,150,86,9.30420666666667,64
"6010","WI-523120",2003,173,98,13.1500390540541,75
"6011","WI-523120",2004,158,76,11.5954662962963,82
"6012","WI-523120",2005,155,79,10.8113485333333,76
"6013","WI-523120",2006,146,82,10.53913,64
"6014","WI-523120",2007,149,99,13.2785283673469,50
"6015","WI-523120",2008,155,82,9.99438333333333,73
"6016","WI-523120",2009,168,71,10.3054691666667,97
"6017","WI-523120",2010,143,65,9.80491753246753,78
"6018","WI-523120",2011,152,88,10.8735019047619,64
"6019","WI-523120",2012,80,59,7.991548,21
"6020","WI-523120",2013,163,84,11.1226191025641,79
"6021","WI-523120",2014,149,86,10.849695483871,63
"6022","WI-523120",2015,158,85,12.1281905555556,73
"6023","WI-523120",2016,145,64,8.878695375,81
"6024","WI-523120",2017,160,77,11.8525892682927,83
"6025","WI-523120",2018,145,107,12.9486221621622,38
"6026","WI-523120",2019,175,69,10.9902608571429,106
"6027","WI-523120",2020,145,64,7.28161375,81
"6028","WI-523120",2021,140,65,9.06738135135135,75
"6029","WI-523120",2022,131,72,7.26577275862069,59
"6030","WI-523120",2023,150,76,9.90970767123288,74
"6031","WI-543247",1979,156,98,11.9686735087719,58
"6032","WI-543247",1980,148,76,9.07110985915493,72
"6033","WI-543247",1981,155,79,11.0604754666667,76
"6034","WI-543247",1982,133,101,11.1246674193548,32
"6035","WI-543247",1983,161,109,10.9330664705882,52
"6036","WI-543247",1984,156,92,9.81190587301587,64
"6037","WI-543247",1985,174,82,13.3496383516484,92
"6038","WI-543247",1986,149,83,11.0563764615385,66
"6039","WI-543247",1987,148,91,12.3005898214286,57
"6040","WI-543247",1988,150,79,9.80653214285714,71
"6041","WI-543247",1989,152,80,10.3244178873239,72
"6042","WI-543247",1990,162,81,10.29131775,81
"6043","WI-543247",1991,132,74,9.04850719298246,58
"6044","WI-543247",1992,164,84,10.5935082278481,80
"6045","WI-543247",1993,162,81,10.15096575,81
"6046","WI-543247",1994,163,70,9.73746673913043,93
"6047","WI-543247",1995,155,68,8.48671848837209,87
"6048","WI-543247",1996,166,98,10.966957761194,68
"6049","WI-543247",1997,169,101,11.4823240298507,68
"6050","WI-543247",1998,135,80,10.7766592592593,55
"6051","WI-543247",1999,154,75,10.9437970512821,79
"6052","WI-543247",2000,127,51,7.97407946666667,76
"6053","WI-543247",2001,161,87,12.5344180821918,74
"6054","WI-543247",2002,150,86,9.55916761904762,64
"6055","WI-543247",2003,167,97,12.8074910144928,70
"6056","WI-543247",2004,158,75,11.6072537804878,83
"6057","WI-543247",2005,154,80,10.9993404109589,74
"6058","WI-543247",2006,146,82,10.5103604761905,64
"6059","WI-543247",2007,149,100,13.73542375,49
"6060","WI-543247",2008,155,74,9.1246565,81
"6061","WI-543247",2009,168,72,10.5456266315789,96
"6062","WI-543247",2010,142,65,9.82405236842105,77
"6063","WI-543247",2011,152,88,10.9362495238095,64
"6064","WI-543247",2012,147,62,12.0036755952381,85
"6065","WI-543247",2013,163,85,11.1689780519481,78
"6066","WI-543247",2014,148,86,10.7113967213115,62
"6067","WI-543247",2015,158,86,12.4397476056338,72
"6068","WI-543247",2016,145,64,8.994906625,81
"6069","WI-543247",2017,160,76,11.8231504819277,84
"6070","WI-543247",2018,144,107,12.9669952777778,37
"6071","WI-543247",2019,175,69,11.0976275238095,106
"6072","WI-543247",2020,145,65,7.43316379746835,80
"6073","WI-543247",2021,140,66,9.1553498630137,74
"6074","WI-543247",2022,130,88,7.71996463414634,42
"6075","WI-543247",2023,150,76,9.9182697260274,74
"6076","WI-563056",1979,180,98,12.7254564197531,82
"6077","WI-563056",1980,144,84,9.85154491525424,60
"6078","WI-563056",1981,156,67,9.92849534090909,89
"6079","WI-563056",1982,182,100,14.0359758024691,82
"6080","WI-563056",1983,162,107,11.1315994444444,55
"6081","WI-563056",1984,157,85,9.51702816901408,72
"6082","WI-563056",1985,179,74,12.4239797115385,105
"6083","WI-563056",1986,148,83,10.89482546875,65
"6084","WI-563056",1987,148,91,13.5889544642857,57
"6085","WI-563056",1988,148,81,10.2983163636364,67
"6086","WI-563056",1989,170,83,11.0487894186047,87
"6087","WI-563056",1990,161,85,10.8456984,76
"6088","WI-563056",1991,132,75,7.872675,57
"6089","WI-563056",1992,163,84,10.4869008974359,79
"6090","WI-563056",1993,185,81,11.5489904854369,104
"6091","WI-563056",1994,164,86,11.2414364935065,78
"6092","WI-563056",1995,154,70,7.92901530120482,84
"6093","WI-563056",1996,163,99,10.2859161904762,64
"6094","WI-563056",1997,163,101,11.1616316393443,62
"6095","WI-563056",1998,136,79,10.8172973214286,57
"6096","WI-563056",1999,156,76,10.8486517721519,80
"6097","WI-563056",2000,161,74,10.6801302325581,87
"6098","WI-563056",2001,160,88,11.6604747887324,72
"6099","WI-563056",2002,150,94,9.33562945454545,56
"6100","WI-563056",2003,164,97,12.5936418181818,67
"6101","WI-563056",2004,158,81,10.6903048684211,77
"6102","WI-563056",2005,154,84,11.1613614492754,70
"6103","WI-563056",2006,146,85,10.1019026666667,61
"6104","WI-563056",2007,151,101,14.6241916326531,50
"6105","WI-563056",2008,174,91,11.6403590243902,83
"6106","WI-563056",2009,166,74,10.2287498901099,92
"6107","WI-563056",2010,141,67,9.67573164383562,74
"6108","WI-563056",2011,154,89,10.29147984375,65
"6109","WI-563056",2012,158,68,12.847862247191,90
"6110","WI-563056",2013,164,94,10.3707050724638,70
"6111","WI-563056",2014,147,92,9.01710333333333,55
"6112","WI-563056",2015,157,85,11.4173453521127,72
"6113","WI-563056",2016,145,64,8.5404145,81
"6114","WI-563056",2017,155,76,10.5728167948718,79
"6115","WI-563056",2018,144,108,13.1900245714286,36
"6116","WI-563056",2019,155,80,9.05053175675676,75
"6117","WI-563056",2020,146,78,7.4942047761194,68
"6118","WI-563056",2021,140,66,8.21003712328767,74
"6119","WI-563056",2022,132,89,6.98514785714286,43
"6120","WI-563056",2023,150,89,11.2294348333333,61
"6121","WI-563057",1979,180,98,12.7254564197531,82
"6122","WI-563057",1980,144,84,9.85154491525424,60
"6123","WI-563057",1981,156,67,9.92849534090909,89
"6124","WI-563057",1982,182,100,14.0359758024691,82
"6125","WI-563057",1983,162,107,11.1315994444444,55
"6126","WI-563057",1984,157,85,9.51702816901408,72
"6127","WI-563057",1985,179,74,12.4239797115385,105
"6128","WI-563057",1986,148,83,10.89482546875,65
"6129","WI-563057",1987,148,91,13.5889544642857,57
"6130","WI-563057",1988,148,81,10.2983163636364,67
"6131","WI-563057",1989,170,83,11.0487894186047,87
"6132","WI-563057",1990,161,85,10.8456984,76
"6133","WI-563057",1991,132,75,7.872675,57
"6134","WI-563057",1992,163,84,10.4869008974359,79
"6135","WI-563057",1993,185,81,11.5489904854369,104
"6136","WI-563057",1994,164,86,11.2414364935065,78
"6137","WI-563057",1995,154,70,7.92901530120482,84
"6138","WI-563057",1996,163,99,10.2859161904762,64
"6139","WI-563057",1997,163,101,11.1616316393443,62
"6140","WI-563057",1998,136,79,10.8172973214286,57
"6141","WI-563057",1999,156,76,10.8486517721519,80
"6142","WI-563057",2000,161,74,10.6801302325581,87
"6143","WI-563057",2001,160,88,11.6604747887324,72
"6144","WI-563057",2002,150,94,9.33562945454545,56
"6145","WI-563057",2003,164,97,12.5936418181818,67
"6146","WI-563057",2004,158,81,10.6903048684211,77
"6147","WI-563057",2005,154,84,11.1613614492754,70
"6148","WI-563057",2006,146,85,10.1019026666667,61
"6149","WI-563057",2007,151,101,14.6241916326531,50
"6150","WI-563057",2008,174,91,11.6403590243902,83
"6151","WI-563057",2009,166,74,10.2287498901099,92
"6152","WI-563057",2010,141,67,9.67573164383562,74
"6153","WI-563057",2011,154,89,10.29147984375,65
"6154","WI-563057",2012,158,68,12.847862247191,90
"6155","WI-563057",2013,164,94,10.3707050724638,70
"6156","WI-563057",2014,147,92,9.01710333333333,55
"6157","WI-563057",2015,157,85,11.4173453521127,72
"6158","WI-563057",2016,145,64,8.5404145,81
"6159","WI-563057",2017,155,76,10.5728167948718,79
"6160","WI-563057",2018,144,108,13.1900245714286,36
"6161","WI-563057",2019,155,80,9.05053175675676,75
"6162","WI-563057",2020,146,78,7.4942047761194,68
"6163","WI-563057",2021,140,66,8.21003712328767,74
"6164","WI-563057",2022,132,89,6.98514785714286,43
"6165","WI-563057",2023,150,89,11.2294348333333,61
"6166","WI-563058",1979,180,98,12.7254564197531,82
"6167","WI-563058",1980,144,84,9.85154491525424,60
"6168","WI-563058",1981,156,67,9.92849534090909,89
"6169","WI-563058",1982,182,100,14.0359758024691,82
"6170","WI-563058",1983,162,107,11.1315994444444,55
"6171","WI-563058",1984,157,85,9.51702816901408,72
"6172","WI-563058",1985,179,74,12.4239797115385,105
"6173","WI-563058",1986,148,83,10.89482546875,65
"6174","WI-563058",1987,148,91,13.5889544642857,57
"6175","WI-563058",1988,148,81,10.2983163636364,67
"6176","WI-563058",1989,170,83,11.0487894186047,87
"6177","WI-563058",1990,161,85,10.8456984,76
"6178","WI-563058",1991,132,75,7.872675,57
"6179","WI-563058",1992,163,84,10.4869008974359,79
"6180","WI-563058",1993,185,81,11.5489904854369,104
"6181","WI-563058",1994,164,86,11.2414364935065,78
"6182","WI-563058",1995,154,70,7.92901530120482,84
"6183","WI-563058",1996,163,99,10.2859161904762,64
"6184","WI-563058",1997,163,101,11.1616316393443,62
"6185","WI-563058",1998,136,79,10.8172973214286,57
"6186","WI-563058",1999,156,76,10.8486517721519,80
"6187","WI-563058",2000,161,74,10.6801302325581,87
"6188","WI-563058",2001,160,88,11.6604747887324,72
"6189","WI-563058",2002,150,94,9.33562945454545,56
"6190","WI-563058",2003,164,97,12.5936418181818,67
"6191","WI-563058",2004,158,81,10.6903048684211,77
"6192","WI-563058",2005,154,84,11.1613614492754,70
"6193","WI-563058",2006,146,85,10.1019026666667,61
"6194","WI-563058",2007,151,101,14.6241916326531,50
"6195","WI-563058",2008,174,91,11.6403590243902,83
"6196","WI-563058",2009,166,74,10.2287498901099,92
"6197","WI-563058",2010,141,67,9.67573164383562,74
"6198","WI-563058",2011,154,89,10.29147984375,65
"6199","WI-563058",2012,158,68,12.847862247191,90
"6200","WI-563058",2013,164,94,10.3707050724638,70
"6201","WI-563058",2014,147,92,9.01710333333333,55
"6202","WI-563058",2015,157,85,11.4173453521127,72
"6203","WI-563058",2016,145,64,8.5404145,81
"6204","WI-563058",2017,155,76,10.5728167948718,79
"6205","WI-563058",2018,144,108,13.1900245714286,36
"6206","WI-563058",2019,155,80,9.05053175675676,75
"6207","WI-563058",2020,146,78,7.4942047761194,68
"6208","WI-563058",2021,140,66,8.21003712328767,74
"6209","WI-563058",2022,132,89,6.98514785714286,43
"6210","WI-563058",2023,150,89,11.2294348333333,61
"6211","WI-563121",1979,180,99,13.001447125,81
"6212","WI-563121",1980,144,84,9.78533779661017,60
"6213","WI-563121",1981,162,67,10.5477481914894,95
"6214","WI-563121",1982,182,100,14.0368445679012,82
"6215","WI-563121",1983,162,85,8.56572539473684,77
"6216","WI-563121",1984,157,84,9.47020972222222,73
"6217","WI-563121",1985,174,74,12.2645205050505,100
"6218","WI-563121",1986,148,83,11.14458046875,65
"6219","WI-563121",1987,148,91,13.4931126785714,57
"6220","WI-563121",1988,149,81,10.3093567164179,68
"6221","WI-563121",1989,170,83,11.1742438372093,87
"6222","WI-563121",1990,161,85,10.8042401333333,76
"6223","WI-563121",1991,132,74,7.89554719298246,58
"6224","WI-563121",1992,163,84,10.4593566666667,79
"6225","WI-563121",1993,184,81,11.3932221568627,103
"6226","WI-563121",1994,164,72,9.87154769230769,92
"6227","WI-563121",1995,154,70,7.99556265060241,84
"6228","WI-563121",1996,163,99,10.3232426984127,64
"6229","WI-563121",1997,163,101,11.120392295082,62
"6230","WI-563121",1998,136,80,11.0210205454545,56
"6231","WI-563121",1999,156,75,10.791039625,81
"6232","WI-563121",2000,161,54,9.64253830188679,107
"6233","WI-563121",2001,160,88,11.6484808450704,72
"6234","WI-563121",2002,150,94,9.47057327272727,56
"6235","WI-563121",2003,164,97,12.5832245454545,67
"6236","WI-563121",2004,158,81,10.8858226315789,77
"6237","WI-563121",2005,154,84,11.1012398550725,70
"6238","WI-563121",2006,146,85,10.0933086666667,61
"6239","WI-563121",2007,151,101,14.61893,50
"6240","WI-563121",2008,175,90,11.7350413095238,85
"6241","WI-563121",2009,166,74,10.2924510989011,92
"6242","WI-563121",2010,141,67,9.73148863013699,74
"6243","WI-563121",2011,154,89,10.317358125,65
"6244","WI-563121",2012,158,67,12.819807,91
"6245","WI-563121",2013,164,94,10.4719276811594,70
"6246","WI-563121",2014,147,92,9.0457487037037,55
"6247","WI-563121",2015,157,86,11.6341355714286,71
"6248","WI-563121",2016,145,64,8.598129125,81
"6249","WI-563121",2017,156,76,10.6993421518987,80
"6250","WI-563121",2018,144,108,12.88623,36
"6251","WI-563121",2019,155,80,9.05781608108108,75
"6252","WI-563121",2020,146,78,7.44861208955224,68
"6253","WI-563121",2021,140,66,8.32144589041096,74
"6254","WI-563121",2022,132,89,7.10494023809524,43
"6255","WI-563121",2023,150,89,11.3281326666667,61
"6256","WI-573060",1979,168,99,12.7822695588235,69
"6257","WI-573060",1980,147,84,9.46927596774194,63
"6258","WI-573060",1981,163,80,11.4315796341463,83
"6259","WI-573060",1982,182,101,13.987018125,81
"6260","WI-573060",1983,162,88,8.50928191780822,74
"6261","WI-573060",1984,157,86,9.11894485714286,71
"6262","WI-573060",1985,175,68,11.4315473584906,107
"6263","WI-573060",1986,149,81,10.992822238806,68
"6264","WI-573060",1987,148,92,12.5586925454545,56
"6265","WI-573060",1988,150,80,9.8367331884058,70
"6266","WI-573060",1989,170,81,11.5061859090909,89
"6267","WI-573060",1990,162,85,10.4368506578947,77
"6268","WI-573060",1991,132,74,8.0756450877193,58
"6269","WI-573060",1992,163,84,10.1130023076923,79
"6270","WI-573060",1993,171,94,11.6668073684211,77
"6271","WI-573060",1994,163,73,9.55303471910112,90
"6272","WI-573060",1995,155,97,9.6644098245614,58
"6273","WI-573060",1996,165,99,10.1929707692308,66
"6274","WI-573060",1997,169,101,11.0796880597015,68
"6275","WI-573060",1998,136,81,10.683142037037,55
"6276","WI-573060",1999,156,75,10.548657,81
"6277","WI-573060",2000,161,51,9.50183844036697,110
"6278","WI-573060",2001,161,88,11.6826254166667,73
"6279","WI-573060",2002,160,94,10.8337790769231,66
"6280","WI-573060",2003,165,97,12.1259362686567,68
"6281","WI-573060",2004,158,79,11.2040485897436,79
"6282","WI-573060",2005,155,82,10.8509115277778,73
"6283","WI-573060",2006,146,84,10.0256847540984,62
"6284","WI-573060",2007,151,100,13.7564088,51
"6285","WI-573060",2008,157,85,9.65073788732394,72
"6286","WI-573060",2009,168,73,9.92431765957447,95
"6287","WI-573060",2010,142,65,9.22331263157895,77
"6288","WI-573060",2011,153,89,10.1514722222222,64
"6289","WI-573060",2012,159,66,12.6417317391304,93
"6290","WI-573060",2013,164,90,10.5868969863014,74
"6291","WI-573060",2014,149,86,9.24611580645161,63
"6292","WI-573060",2015,158,86,11.4910236619718,72
"6293","WI-573060",2016,145,64,8.289144625,81
"6294","WI-573060",2017,159,76,10.8731996341463,83
"6295","WI-573060",2018,144,108,12.8107845714286,36
"6296","WI-573060",2019,157,78,9.61969025641026,79
"6297","WI-573060",2020,146,65,6.477192125,81
"6298","WI-573060",2021,141,65,8.33820453333333,76
"6299","WI-573060",2022,130,89,6.543118,41
"6300","WI-573060",2023,150,79,9.83237042857143,71
"6301","WI-573124",1979,168,99,12.7822695588235,69
"6302","WI-573124",1980,147,84,9.46927596774194,63
"6303","WI-573124",1981,163,80,11.4315796341463,83
"6304","WI-573124",1982,182,101,13.987018125,81
"6305","WI-573124",1983,162,88,8.50928191780822,74
"6306","WI-573124",1984,157,86,9.11894485714286,71
"6307","WI-573124",1985,175,68,11.4315473584906,107
"6308","WI-573124",1986,149,81,10.992822238806,68
"6309","WI-573124",1987,148,92,12.5586925454545,56
"6310","WI-573124",1988,150,80,9.8367331884058,70
"6311","WI-573124",1989,170,81,11.5061859090909,89
"6312","WI-573124",1990,162,85,10.4368506578947,77
"6313","WI-573124",1991,132,74,8.0756450877193,58
"6314","WI-573124",1992,163,84,10.1130023076923,79
"6315","WI-573124",1993,171,94,11.6668073684211,77
"6316","WI-573124",1994,163,73,9.55303471910112,90
"6317","WI-573124",1995,155,97,9.6644098245614,58
"6318","WI-573124",1996,165,99,10.1929707692308,66
"6319","WI-573124",1997,169,101,11.0796880597015,68
"6320","WI-573124",1998,136,81,10.683142037037,55
"6321","WI-573124",1999,156,75,10.548657,81
"6322","WI-573124",2000,161,51,9.50183844036697,110
"6323","WI-573124",2001,161,88,11.6826254166667,73
"6324","WI-573124",2002,160,94,10.8337790769231,66
"6325","WI-573124",2003,165,97,12.1259362686567,68
"6326","WI-573124",2004,158,79,11.2040485897436,79
"6327","WI-573124",2005,155,82,10.8509115277778,73
"6328","WI-573124",2006,146,84,10.0256847540984,62
"6329","WI-573124",2007,151,100,13.7564088,51
"6330","WI-573124",2008,157,85,9.65073788732394,72
"6331","WI-573124",2009,168,73,9.92431765957447,95
"6332","WI-573124",2010,142,65,9.22331263157895,77
"6333","WI-573124",2011,153,89,10.1514722222222,64
"6334","WI-573124",2012,159,66,12.6417317391304,93
"6335","WI-573124",2013,164,90,10.5868969863014,74
"6336","WI-573124",2014,149,86,9.24611580645161,63
"6337","WI-573124",2015,158,86,11.4910236619718,72
"6338","WI-573124",2016,145,64,8.289144625,81
"6339","WI-573124",2017,159,76,10.8731996341463,83
"6340","WI-573124",2018,144,108,12.8107845714286,36
"6341","WI-573124",2019,157,78,9.61969025641026,79
"6342","WI-573124",2020,146,65,6.477192125,81
"6343","WI-573124",2021,141,65,8.33820453333333,76
"6344","WI-573124",2022,130,89,6.543118,41
"6345","WI-573124",2023,150,79,9.83237042857143,71
"6346","WI-583046",1979,190,100,11.7285212359551,90
"6347","WI-583046",1980,147,88,9.35328724137931,59
"6348","WI-583046",1981,182,79,11.2793023529412,103
"6349","WI-583046",1982,184,100,12.2642357831325,84
"6350","WI-583046",1983,172,108,11.1059674603175,64
"6351","WI-583046",1984,193,91,12.1749521782178,102
"6352","WI-583046",1985,185,96,13.3622438636364,89
"6353","WI-583046",1986,186,84,12.3808808910891,102
"6354","WI-583046",1987,150,92,11.9982233333333,58
"6355","WI-583046",1988,150,84,9.19388569230769,66
"6356","WI-583046",1989,171,101,11.303754057971,70
"6357","WI-583046",1990,177,99,12.2810157142857,78
"6358","WI-583046",1991,133,90,8.27623261904762,43
"6359","WI-583046",1992,NA,90,NA,NA
"6360","WI-583046",1993,207,93,12.4778109734513,114
"6361","WI-583046",1994,166,90,10.0845464,76
"6362","WI-583046",1995,166,98,9.67256791044776,68
"6363","WI-583046",1996,179,104,10.8310737837838,75
"6364","WI-583046",1997,173,102,10.6075787142857,71
"6365","WI-583046",1998,167,81,11.6105182352941,86
"6366","WI-583046",1999,157,84,10.5165030555556,73
"6367","WI-583046",2000,189,77,11.3388081981982,112
"6368","WI-583046",2001,162,89,10.4512281944444,73
"6369","WI-583046",2002,160,96,9.08213333333333,64
"6370","WI-583046",2003,167,98,11.6874067647059,69
"6371","WI-583046",2004,194,83,11.3211538181818,111
"6372","WI-583046",2005,158,85,10.2353897222222,73
"6373","WI-583046",2006,146,86,9.08764372881356,60
"6374","WI-583046",2007,163,101,13.8800975409836,62
"6375","WI-583046",2008,190,91,11.5065187755102,99
"6376","WI-583046",2009,168,95,10.5905506944444,73
"6377","WI-583046",2010,142,66,8.47937186666667,76
"6378","WI-583046",2011,179,89,11.2010574157303,90
"6379","WI-583046",2012,160,70,10.393548988764,90
"6380","WI-583046",2013,173,103,11.2975434782609,70
"6381","WI-583046",2014,149,106,9.20181333333333,43
"6382","WI-583046",2015,192,86,12.8366774285714,106
"6383","WI-583046",2016,164,100,12.4461374603175,64
"6384","WI-583046",2017,160,77,9.58629707317073,83
"6385","WI-583046",2018,144,109,11.6690152941176,35
"6386","WI-583046",2019,177,91,10.7051794117647,86
"6387","WI-583046",2020,178,107,12.772979,71
"6388","WI-583046",2021,142,76,7.79521076923077,66
"6389","WI-583046",2022,168,107,12.410859,61
"6390","WI-583046",2023,151,96,10.1909524074074,55
"6391","WI-583047",1979,190,100,11.7285212359551,90
"6392","WI-583047",1980,147,88,9.35328724137931,59
"6393","WI-583047",1981,182,79,11.2793023529412,103
"6394","WI-583047",1982,184,100,12.2642357831325,84
"6395","WI-583047",1983,172,108,11.1059674603175,64
"6396","WI-583047",1984,193,91,12.1749521782178,102
"6397","WI-583047",1985,185,96,13.3622438636364,89
"6398","WI-583047",1986,186,84,12.3808808910891,102
"6399","WI-583047",1987,150,92,11.9982233333333,58
"6400","WI-583047",1988,150,84,9.19388569230769,66
"6401","WI-583047",1989,171,101,11.303754057971,70
"6402","WI-583047",1990,177,99,12.2810157142857,78
"6403","WI-583047",1991,133,90,8.27623261904762,43
"6404","WI-583047",1992,NA,90,NA,NA
"6405","WI-583047",1993,207,93,12.4778109734513,114
"6406","WI-583047",1994,166,90,10.0845464,76
"6407","WI-583047",1995,166,98,9.67256791044776,68
"6408","WI-583047",1996,179,104,10.8310737837838,75
"6409","WI-583047",1997,173,102,10.6075787142857,71
"6410","WI-583047",1998,167,81,11.6105182352941,86
"6411","WI-583047",1999,157,84,10.5165030555556,73
"6412","WI-583047",2000,189,77,11.3388081981982,112
"6413","WI-583047",2001,162,89,10.4512281944444,73
"6414","WI-583047",2002,160,96,9.08213333333333,64
"6415","WI-583047",2003,167,98,11.6874067647059,69
"6416","WI-583047",2004,194,83,11.3211538181818,111
"6417","WI-583047",2005,158,85,10.2353897222222,73
"6418","WI-583047",2006,146,86,9.08764372881356,60
"6419","WI-583047",2007,163,101,13.8800975409836,62
"6420","WI-583047",2008,190,91,11.5065187755102,99
"6421","WI-583047",2009,168,95,10.5905506944444,73
"6422","WI-583047",2010,142,66,8.47937186666667,76
"6423","WI-583047",2011,179,89,11.2010574157303,90
"6424","WI-583047",2012,160,70,10.393548988764,90
"6425","WI-583047",2013,173,103,11.2975434782609,70
"6426","WI-583047",2014,149,106,9.20181333333333,43
"6427","WI-583047",2015,192,86,12.8366774285714,106
"6428","WI-583047",2016,164,100,12.4461374603175,64
"6429","WI-583047",2017,160,77,9.58629707317073,83
"6430","WI-583047",2018,144,109,11.6690152941176,35
"6431","WI-583047",2019,177,91,10.7051794117647,86
"6432","WI-583047",2020,178,107,12.772979,71
"6433","WI-583047",2021,142,76,7.79521076923077,66
"6434","WI-583047",2022,168,107,12.410859,61
"6435","WI-583047",2023,151,96,10.1909524074074,55
"6436","WI-583067",1979,190,100,11.7285212359551,90
"6437","WI-583067",1980,147,88,9.35328724137931,59
"6438","WI-583067",1981,182,79,11.2793023529412,103
"6439","WI-583067",1982,184,100,12.2642357831325,84
"6440","WI-583067",1983,172,108,11.1059674603175,64
"6441","WI-583067",1984,193,91,12.1749521782178,102
"6442","WI-583067",1985,185,96,13.3622438636364,89
"6443","WI-583067",1986,186,84,12.3808808910891,102
"6444","WI-583067",1987,150,92,11.9982233333333,58
"6445","WI-583067",1988,150,84,9.19388569230769,66
"6446","WI-583067",1989,171,101,11.303754057971,70
"6447","WI-583067",1990,177,99,12.2810157142857,78
"6448","WI-583067",1991,133,90,8.27623261904762,43
"6449","WI-583067",1992,NA,90,NA,NA
"6450","WI-583067",1993,207,93,12.4778109734513,114
"6451","WI-583067",1994,166,90,10.0845464,76
"6452","WI-583067",1995,166,98,9.67256791044776,68
"6453","WI-583067",1996,179,104,10.8310737837838,75
"6454","WI-583067",1997,173,102,10.6075787142857,71
"6455","WI-583067",1998,167,81,11.6105182352941,86
"6456","WI-583067",1999,157,84,10.5165030555556,73
"6457","WI-583067",2000,189,77,11.3388081981982,112
"6458","WI-583067",2001,162,89,10.4512281944444,73
"6459","WI-583067",2002,160,96,9.08213333333333,64
"6460","WI-583067",2003,167,98,11.6874067647059,69
"6461","WI-583067",2004,194,83,11.3211538181818,111
"6462","WI-583067",2005,158,85,10.2353897222222,73
"6463","WI-583067",2006,146,86,9.08764372881356,60
"6464","WI-583067",2007,163,101,13.8800975409836,62
"6465","WI-583067",2008,190,91,11.5065187755102,99
"6466","WI-583067",2009,168,95,10.5905506944444,73
"6467","WI-583067",2010,142,66,8.47937186666667,76
"6468","WI-583067",2011,179,89,11.2010574157303,90
"6469","WI-583067",2012,160,70,10.393548988764,90
"6470","WI-583067",2013,173,103,11.2975434782609,70
"6471","WI-583067",2014,149,106,9.20181333333333,43
"6472","WI-583067",2015,192,86,12.8366774285714,106
"6473","WI-583067",2016,164,100,12.4461374603175,64
"6474","WI-583067",2017,160,77,9.58629707317073,83
"6475","WI-583067",2018,144,109,11.6690152941176,35
"6476","WI-583067",2019,177,91,10.7051794117647,86
"6477","WI-583067",2020,178,107,12.772979,71
"6478","WI-583067",2021,142,76,7.79521076923077,66
"6479","WI-583067",2022,168,107,12.410859,61
"6480","WI-583067",2023,151,96,10.1909524074074,55
"6481","WI-583086",1979,190,101,11.1707845454545,89
"6482","WI-583086",1980,175,104,13.2273198571429,71
"6483","WI-583086",1981,184,80,10.7772301941748,104
"6484","WI-583086",1982,185,100,11.8561675,85
"6485","WI-583086",1983,173,108,10.6536921875,65
"6486","WI-583086",1984,193,91,11.5878545544554,102
"6487","WI-583086",1985,186,97,12.9291029545455,89
"6488","WI-583086",1986,186,84,11.7403328712871,102
"6489","WI-583086",1987,150,93,11.6771516071429,57
"6490","WI-583086",1988,150,85,8.7123890625,65
"6491","WI-583086",1989,172,102,10.7835886956522,70
"6492","WI-583086",1990,178,99,11.8509114102564,79
"6493","WI-583086",1991,133,90,7.7282430952381,43
"6494","WI-583086",1992,NA,105,NA,NA
"6495","WI-583086",1993,222,94,12.5267058267717,128
"6496","WI-583086",1994,166,95,10.0857457142857,71
"6497","WI-583086",1995,166,100,9.28519476923077,66
"6498","WI-583086",1996,180,106,10.6062726027397,74
"6499","WI-583086",1997,173,103,9.97321115942029,70
"6500","WI-583086",1998,169,81,11.154425862069,88
"6501","WI-583086",1999,157,84,9.92036625,73
"6502","WI-583086",2000,193,78,11.155653245614,115
"6503","WI-583086",2001,163,89,9.98027602739726,74
"6504","WI-583086",2002,173,97,10.0733254666667,76
"6505","WI-583086",2003,183,98,12.4291133333333,85
"6506","WI-583086",2004,194,83,10.6892648181818,111
"6507","WI-583086",2005,160,85,10.0139594594595,75
"6508","WI-583086",2006,146,86,8.83539288135593,60
"6509","WI-583086",2007,163,101,13.3525614754098,62
"6510","WI-583086",2008,191,102,12.1673682954545,89
"6511","WI-583086",2009,169,96,10.2481777777778,73
"6512","WI-583086",2010,142,66,8.0493716,76
"6513","WI-583086",2011,179,89,10.5083786516854,90
"6514","WI-583086",2012,170,69,10.8383295,101
"6515","WI-583086",2013,173,108,11.59182390625,65
"6516","WI-583086",2014,177,106,12.519223,71
"6517","WI-583086",2015,192,87,12.3710478846154,105
"6518","WI-583086",2016,169,101,12.5124458208955,68
"6519","WI-583086",2017,161,78,9.11233195121951,83
"6520","WI-583086",2018,144,109,11.4247597058824,35
"6521","WI-583086",2019,178,92,10.1974532941176,86
"6522","WI-583086",2020,179,108,12.4700415714286,71
"6523","WI-583086",2021,155,75,8.39623455696202,80
"6524","WI-583086",2022,169,108,12.2141876666667,61
"6525","WI-583086",2023,151,97,10.0485964150943,54
"6526","WI-583088",1979,190,100,11.7285212359551,90
"6527","WI-583088",1980,147,88,9.35328724137931,59
"6528","WI-583088",1981,182,79,11.2793023529412,103
"6529","WI-583088",1982,184,100,12.2642357831325,84
"6530","WI-583088",1983,172,108,11.1059674603175,64
"6531","WI-583088",1984,193,91,12.1749521782178,102
"6532","WI-583088",1985,185,96,13.3622438636364,89
"6533","WI-583088",1986,186,84,12.3808808910891,102
"6534","WI-583088",1987,150,92,11.9982233333333,58
"6535","WI-583088",1988,150,84,9.19388569230769,66
"6536","WI-583088",1989,171,101,11.303754057971,70
"6537","WI-583088",1990,177,99,12.2810157142857,78
"6538","WI-583088",1991,133,90,8.27623261904762,43
"6539","WI-583088",1992,NA,90,NA,NA
"6540","WI-583088",1993,207,93,12.4778109734513,114
"6541","WI-583088",1994,166,90,10.0845464,76
"6542","WI-583088",1995,166,98,9.67256791044776,68
"6543","WI-583088",1996,179,104,10.8310737837838,75
"6544","WI-583088",1997,173,102,10.6075787142857,71
"6545","WI-583088",1998,167,81,11.6105182352941,86
"6546","WI-583088",1999,157,84,10.5165030555556,73
"6547","WI-583088",2000,189,77,11.3388081981982,112
"6548","WI-583088",2001,162,89,10.4512281944444,73
"6549","WI-583088",2002,160,96,9.08213333333333,64
"6550","WI-583088",2003,167,98,11.6874067647059,69
"6551","WI-583088",2004,194,83,11.3211538181818,111
"6552","WI-583088",2005,158,85,10.2353897222222,73
"6553","WI-583088",2006,146,86,9.08764372881356,60
"6554","WI-583088",2007,163,101,13.8800975409836,62
"6555","WI-583088",2008,190,91,11.5065187755102,99
"6556","WI-583088",2009,168,95,10.5905506944444,73
"6557","WI-583088",2010,142,66,8.47937186666667,76
"6558","WI-583088",2011,179,89,11.2010574157303,90
"6559","WI-583088",2012,160,70,10.393548988764,90
"6560","WI-583088",2013,173,103,11.2975434782609,70
"6561","WI-583088",2014,149,106,9.20181333333333,43
"6562","WI-583088",2015,192,86,12.8366774285714,106
"6563","WI-583088",2016,164,100,12.4461374603175,64
"6564","WI-583088",2017,160,77,9.58629707317073,83
"6565","WI-583088",2018,144,109,11.6690152941176,35
"6566","WI-583088",2019,177,91,10.7051794117647,86
"6567","WI-583088",2020,178,107,12.772979,71
"6568","WI-583088",2021,142,76,7.79521076923077,66
"6569","WI-583088",2022,168,107,12.410859,61
"6570","WI-583088",2023,151,96,10.1909524074074,55
"6571","WI-583092",1979,190,100,11.7285212359551,90
"6572","WI-583092",1980,147,88,9.35328724137931,59
"6573","WI-583092",1981,182,79,11.2793023529412,103
"6574","WI-583092",1982,184,100,12.2642357831325,84
"6575","WI-583092",1983,172,108,11.1059674603175,64
"6576","WI-583092",1984,193,91,12.1749521782178,102
"6577","WI-583092",1985,185,96,13.3622438636364,89
"6578","WI-583092",1986,186,84,12.3808808910891,102
"6579","WI-583092",1987,150,92,11.9982233333333,58
"6580","WI-583092",1988,150,84,9.19388569230769,66
"6581","WI-583092",1989,171,101,11.303754057971,70
"6582","WI-583092",1990,177,99,12.2810157142857,78
"6583","WI-583092",1991,133,90,8.27623261904762,43
"6584","WI-583092",1992,NA,90,NA,NA
"6585","WI-583092",1993,207,93,12.4778109734513,114
"6586","WI-583092",1994,166,90,10.0845464,76
"6587","WI-583092",1995,166,98,9.67256791044776,68
"6588","WI-583092",1996,179,104,10.8310737837838,75
"6589","WI-583092",1997,173,102,10.6075787142857,71
"6590","WI-583092",1998,167,81,11.6105182352941,86
"6591","WI-583092",1999,157,84,10.5165030555556,73
"6592","WI-583092",2000,189,77,11.3388081981982,112
"6593","WI-583092",2001,162,89,10.4512281944444,73
"6594","WI-583092",2002,160,96,9.08213333333333,64
"6595","WI-583092",2003,167,98,11.6874067647059,69
"6596","WI-583092",2004,194,83,11.3211538181818,111
"6597","WI-583092",2005,158,85,10.2353897222222,73
"6598","WI-583092",2006,146,86,9.08764372881356,60
"6599","WI-583092",2007,163,101,13.8800975409836,62
"6600","WI-583092",2008,190,91,11.5065187755102,99
"6601","WI-583092",2009,168,95,10.5905506944444,73
"6602","WI-583092",2010,142,66,8.47937186666667,76
"6603","WI-583092",2011,179,89,11.2010574157303,90
"6604","WI-583092",2012,160,70,10.393548988764,90
"6605","WI-583092",2013,173,103,11.2975434782609,70
"6606","WI-583092",2014,149,106,9.20181333333333,43
"6607","WI-583092",2015,192,86,12.8366774285714,106
"6608","WI-583092",2016,164,100,12.4461374603175,64
"6609","WI-583092",2017,160,77,9.58629707317073,83
"6610","WI-583092",2018,144,109,11.6690152941176,35
"6611","WI-583092",2019,177,91,10.7051794117647,86
"6612","WI-583092",2020,178,107,12.772979,71
"6613","WI-583092",2021,142,76,7.79521076923077,66
"6614","WI-583092",2022,168,107,12.410859,61
"6615","WI-583092",2023,151,96,10.1909524074074,55
"6616","WI-583204",1979,190,101,11.2301770454545,89
"6617","WI-583204",1980,147,104,11.2085071428571,43
"6618","WI-583204",1981,184,80,10.7868638834951,104
"6619","WI-583204",1982,185,101,12.0813803614458,84
"6620","WI-583204",1983,173,109,10.7809746031746,64
"6621","WI-583204",1984,193,92,11.6210157,101
"6622","WI-583204",1985,186,98,13.332951954023,88
"6623","WI-583204",1986,186,84,11.8429787128713,102
"6624","WI-583204",1987,150,93,11.6697575,57
"6625","WI-583204",1988,150,85,8.67491359375,65
"6626","WI-583204",1989,172,102,10.9484439130435,70
"6627","WI-583204",1990,178,99,11.9022934615385,79
"6628","WI-583204",1991,133,90,7.64063071428571,43
"6629","WI-583204",1992,NA,105,NA,NA
"6630","WI-583204",1993,222,94,12.6175025984252,128
"6631","WI-583204",1994,165,95,9.96148304347826,70
"6632","WI-583204",1995,166,99,9.21733393939394,67
"6633","WI-583204",1996,180,106,10.6124793150685,74
"6634","WI-583204",1997,173,103,9.99834695652174,70
"6635","WI-583204",1998,168,81,11.1105808139535,87
"6636","WI-583204",1999,157,85,10.1895235211268,72
"6637","WI-583204",2000,193,78,11.2036242982456,115
"6638","WI-583204",2001,163,89,9.92558849315068,74
"6639","WI-583204",2002,173,97,10.1610333333333,76
"6640","WI-583204",2003,183,98,12.4193477380952,85
"6641","WI-583204",2004,194,83,10.7875606363636,111
"6642","WI-583204",2005,158,85,9.73625722222222,73
"6643","WI-583204",2006,146,86,8.71383593220339,60
"6644","WI-583204",2007,163,101,13.2702098360656,62
"6645","WI-583204",2008,190,102,12.1568505747126,88
"6646","WI-583204",2009,169,98,10.5756737142857,71
"6647","WI-583204",2010,142,66,7.92530893333333,76
"6648","WI-583204",2011,179,89,10.5669284269663,90
"6649","WI-583204",2012,169,68,10.6373575,101
"6650","WI-583204",2013,173,108,11.74160375,65
"6651","WI-583204",2014,170,106,11.9224749206349,64
"6652","WI-583204",2015,192,87,12.3222192307692,105
"6653","WI-583204",2016,169,101,12.5929037313433,68
"6654","WI-583204",2017,161,79,9.18442111111111,82
"6655","WI-583204",2018,145,109,11.5824357142857,36
"6656","WI-583204",2019,178,102,11.2607304,76
"6657","WI-583204",2020,179,109,12.5577868115942,70
"6658","WI-583204",2021,142,76,7.29328815384615,66
"6659","WI-583204",2022,168,108,12.2234303389831,60
"6660","WI-583204",2023,151,97,10.1545803773585,54
"6661","WI-593002",1979,190,103,11.9575036046512,87
"6662","WI-593002",1980,175,91,11.3938645783133,84
"6663","WI-593002",1981,164,81,9.53333890243903,83
"6664","WI-593002",1982,185,102,13.0274015853659,83
"6665","WI-593002",1983,172,108,10.9645976190476,64
"6666","WI-593002",1984,193,92,12.2164845,101
"6667","WI-593002",1985,186,82,12.1343447572816,104
"6668","WI-593002",1986,176,84,11.8963973626374,92
"6669","WI-593002",1987,149,92,11.3303073214286,57
"6670","WI-593002",1988,150,83,8.95780772727273,67
"6671","WI-593002",1989,172,83,10.0007609090909,89
"6672","WI-593002",1990,166,86,10.1315378481013,80
"6673","WI-593002",1991,133,74,7.03500862068966,59
"6674","WI-593002",1992,235,85,12.924302147651,150
"6675","WI-593002",1993,186,81,10.3614845192308,105
"6676","WI-593002",1994,164,87,9.59763394736842,77
"6677","WI-593002",1995,167,97,10.2932353623188,70
"6678","WI-593002",1996,179,102,10.5469113157895,77
"6679","WI-593002",1997,172,102,10.34,70
"6680","WI-593002",1998,167,82,11.8334222619048,85
"6681","WI-593002",1999,157,83,10.7544993150685,74
"6682","WI-593002",2000,193,53,10.9139403597122,140
"6683","WI-593002",2001,162,88,10.8487424657534,74
"6684","WI-593002",2002,172,95,10.9068330263158,77
"6685","WI-593002",2003,174,97,11.9698067105263,77
"6686","WI-593002",2004,193,82,11.8787905454545,111
"6687","WI-593002",2005,155,83,9.83514633802817,72
"6688","WI-593002",2006,147,83,9.39805317460318,64
"6689","WI-593002",2007,151,99,12.3087460784314,52
"6690","WI-593002",2008,177,86,11.0420034444444,91
"6691","WI-593002",2009,169,74,9.08585819148936,95
"6692","WI-593002",2010,143,65,8.56851376623377,78
"6693","WI-593002",2011,156,89,9.39015121212121,67
"6694","WI-593002",2012,168,67,11.9383352,101
"6695","WI-593002",2013,173,93,11.132132278481,80
"6696","WI-593002",2014,176,88,11.4651802298851,88
"6697","WI-593002",2015,189,87,13.003704950495,102
"6698","WI-593002",2016,146,98,9.54100489361702,48
"6699","WI-593002",2017,160,76,9.85345867469879,84
"6700","WI-593002",2018,145,108,11.9568308333333,37
"6701","WI-593002",2019,177,82,10.0439115957447,95
"6702","WI-593002",2020,172,84,9.79997321839081,88
"6703","WI-593002",2021,142,67,7.82043824324324,75
"6704","WI-593002",2022,132,90,6.19358951219512,42
"6705","WI-593002",2023,151,81,9.19742869565217,70
"6706","WI-593003",1979,190,101,12.84887375,89
"6707","WI-593003",1980,175,88,11.9304725581395,87
"6708","WI-593003",1981,163,82,8.977192875,81
"6709","WI-593003",1982,185,102,13.3765820731707,83
"6710","WI-593003",1983,163,108,9.89748277777778,55
"6711","WI-593003",1984,157,92,8.6016359375,65
"6712","WI-593003",1985,181,82,12.3133602040816,99
"6713","WI-593003",1986,175,84,12.4350091111111,91
"6714","WI-593003",1987,148,92,11.5542892727273,56
"6715","WI-593003",1988,150,82,9.24451925373134,68
"6716","WI-593003",1989,171,82,10.34429,89
"6717","WI-593003",1990,165,85,10.2072558227848,80
"6718","WI-593003",1991,133,74,7.46092413793103,59
"6719","WI-593003",1992,220,84,12.7151720740741,136
"6720","WI-593003",1993,185,81,10.669136407767,104
"6721","WI-593003",1994,164,78,9.30951505882353,86
"6722","WI-593003",1995,166,97,10.6358676470588,69
"6723","WI-593003",1996,179,100,10.7911647435897,79
"6724","WI-593003",1997,172,101,10.5503104285714,71
"6725","WI-593003",1998,136,82,10.1454005660377,54
"6726","WI-593003",1999,157,74,10.2438769512195,83
"6727","WI-593003",2000,163,53,9.31004495412844,110
"6728","WI-593003",2001,161,88,11.1366177777778,73
"6729","WI-593003",2002,172,95,11.3824701315789,77
"6730","WI-593003",2003,173,97,12.2932028,76
"6731","WI-593003",2004,193,81,12.3957246846847,112
"6732","WI-593003",2005,155,83,10.3041167605634,72
"6733","WI-593003",2006,146,83,9.60934548387097,63
"6734","WI-593003",2007,151,99,12.6789988235294,52
"6735","WI-593003",2008,160,85,9.75246378378378,75
"6736","WI-593003",2009,168,74,9.44954075268817,94
"6737","WI-593003",2010,143,65,8.75682558441559,78
"6738","WI-593003",2011,156,89,9.78929893939394,67
"6739","WI-593003",2012,168,67,12.310054,101
"6740","WI-593003",2013,165,93,10.710416056338,72
"6741","WI-593003",2014,170,88,11.273939382716,82
"6742","WI-593003",2015,174,86,12.194691954023,88
"6743","WI-593003",2016,146,97,9.78007979166667,49
"6744","WI-593003",2017,160,76,10.219423253012,84
"6745","WI-593003",2018,145,108,12.3324816666667,37
"6746","WI-593003",2019,176,79,10.1857980208333,97
"6747","WI-593003",2020,147,81,7.00505261538462,66
"6748","WI-593003",2021,140,67,7.92526958333333,73
"6749","WI-593003",2022,132,90,6.92224731707317,42
"6750","WI-593003",2023,150,80,9.28563463768116,70
"6751","WI-593043",1979,190,101,12.84887375,89
"6752","WI-593043",1980,175,88,11.9304725581395,87
"6753","WI-593043",1981,163,82,8.977192875,81
"6754","WI-593043",1982,185,102,13.3765820731707,83
"6755","WI-593043",1983,163,108,9.89748277777778,55
"6756","WI-593043",1984,157,92,8.6016359375,65
"6757","WI-593043",1985,181,82,12.3133602040816,99
"6758","WI-593043",1986,175,84,12.4350091111111,91
"6759","WI-593043",1987,148,92,11.5542892727273,56
"6760","WI-593043",1988,150,82,9.24451925373134,68
"6761","WI-593043",1989,171,82,10.34429,89
"6762","WI-593043",1990,165,85,10.2072558227848,80
"6763","WI-593043",1991,133,74,7.46092413793103,59
"6764","WI-593043",1992,220,84,12.7151720740741,136
"6765","WI-593043",1993,185,81,10.669136407767,104
"6766","WI-593043",1994,164,78,9.30951505882353,86
"6767","WI-593043",1995,166,97,10.6358676470588,69
"6768","WI-593043",1996,179,100,10.7911647435897,79
"6769","WI-593043",1997,172,101,10.5503104285714,71
"6770","WI-593043",1998,136,82,10.1454005660377,54
"6771","WI-593043",1999,157,74,10.2438769512195,83
"6772","WI-593043",2000,163,53,9.31004495412844,110
"6773","WI-593043",2001,161,88,11.1366177777778,73
"6774","WI-593043",2002,172,95,11.3824701315789,77
"6775","WI-593043",2003,173,97,12.2932028,76
"6776","WI-593043",2004,193,81,12.3957246846847,112
"6777","WI-593043",2005,155,83,10.3041167605634,72
"6778","WI-593043",2006,146,83,9.60934548387097,63
"6779","WI-593043",2007,151,99,12.6789988235294,52
"6780","WI-593043",2008,160,85,9.75246378378378,75
"6781","WI-593043",2009,168,74,9.44954075268817,94
"6782","WI-593043",2010,143,65,8.75682558441559,78
"6783","WI-593043",2011,156,89,9.78929893939394,67
"6784","WI-593043",2012,168,67,12.310054,101
"6785","WI-593043",2013,165,93,10.710416056338,72
"6786","WI-593043",2014,170,88,11.273939382716,82
"6787","WI-593043",2015,174,86,12.194691954023,88
"6788","WI-593043",2016,146,97,9.78007979166667,49
"6789","WI-593043",2017,160,76,10.219423253012,84
"6790","WI-593043",2018,145,108,12.3324816666667,37
"6791","WI-593043",2019,176,79,10.1857980208333,97
"6792","WI-593043",2020,147,81,7.00505261538462,66
"6793","WI-593043",2021,140,67,7.92526958333333,73
"6794","WI-593043",2022,132,90,6.92224731707317,42
"6795","WI-593043",2023,150,80,9.28563463768116,70
"6796","WI-593044",1979,190,101,12.84887375,89
"6797","WI-593044",1980,175,88,11.9304725581395,87
"6798","WI-593044",1981,163,82,8.977192875,81
"6799","WI-593044",1982,185,102,13.3765820731707,83
"6800","WI-593044",1983,163,108,9.89748277777778,55
"6801","WI-593044",1984,157,92,8.6016359375,65
"6802","WI-593044",1985,181,82,12.3133602040816,99
"6803","WI-593044",1986,175,84,12.4350091111111,91
"6804","WI-593044",1987,148,92,11.5542892727273,56
"6805","WI-593044",1988,150,82,9.24451925373134,68
"6806","WI-593044",1989,171,82,10.34429,89
"6807","WI-593044",1990,165,85,10.2072558227848,80
"6808","WI-593044",1991,133,74,7.46092413793103,59
"6809","WI-593044",1992,220,84,12.7151720740741,136
"6810","WI-593044",1993,185,81,10.669136407767,104
"6811","WI-593044",1994,164,78,9.30951505882353,86
"6812","WI-593044",1995,166,97,10.6358676470588,69
"6813","WI-593044",1996,179,100,10.7911647435897,79
"6814","WI-593044",1997,172,101,10.5503104285714,71
"6815","WI-593044",1998,136,82,10.1454005660377,54
"6816","WI-593044",1999,157,74,10.2438769512195,83
"6817","WI-593044",2000,163,53,9.31004495412844,110
"6818","WI-593044",2001,161,88,11.1366177777778,73
"6819","WI-593044",2002,172,95,11.3824701315789,77
"6820","WI-593044",2003,173,97,12.2932028,76
"6821","WI-593044",2004,193,81,12.3957246846847,112
"6822","WI-593044",2005,155,83,10.3041167605634,72
"6823","WI-593044",2006,146,83,9.60934548387097,63
"6824","WI-593044",2007,151,99,12.6789988235294,52
"6825","WI-593044",2008,160,85,9.75246378378378,75
"6826","WI-593044",2009,168,74,9.44954075268817,94
"6827","WI-593044",2010,143,65,8.75682558441559,78
"6828","WI-593044",2011,156,89,9.78929893939394,67
"6829","WI-593044",2012,168,67,12.310054,101
"6830","WI-593044",2013,165,93,10.710416056338,72
"6831","WI-593044",2014,170,88,11.273939382716,82
"6832","WI-593044",2015,174,86,12.194691954023,88
"6833","WI-593044",2016,146,97,9.78007979166667,49
"6834","WI-593044",2017,160,76,10.219423253012,84
"6835","WI-593044",2018,145,108,12.3324816666667,37
"6836","WI-593044",2019,176,79,10.1857980208333,97
"6837","WI-593044",2020,147,81,7.00505261538462,66
"6838","WI-593044",2021,140,67,7.92526958333333,73
"6839","WI-593044",2022,132,90,6.92224731707317,42
"6840","WI-593044",2023,150,80,9.28563463768116,70
"6841","WI-593045",1979,190,101,12.84887375,89
"6842","WI-593045",1980,175,88,11.9304725581395,87
"6843","WI-593045",1981,163,82,8.977192875,81
"6844","WI-593045",1982,185,102,13.3765820731707,83
"6845","WI-593045",1983,163,108,9.89748277777778,55
"6846","WI-593045",1984,157,92,8.6016359375,65
"6847","WI-593045",1985,181,82,12.3133602040816,99
"6848","WI-593045",1986,175,84,12.4350091111111,91
"6849","WI-593045",1987,148,92,11.5542892727273,56
"6850","WI-593045",1988,150,82,9.24451925373134,68
"6851","WI-593045",1989,171,82,10.34429,89
"6852","WI-593045",1990,165,85,10.2072558227848,80
"6853","WI-593045",1991,133,74,7.46092413793103,59
"6854","WI-593045",1992,220,84,12.7151720740741,136
"6855","WI-593045",1993,185,81,10.669136407767,104
"6856","WI-593045",1994,164,78,9.30951505882353,86
"6857","WI-593045",1995,166,97,10.6358676470588,69
"6858","WI-593045",1996,179,100,10.7911647435897,79
"6859","WI-593045",1997,172,101,10.5503104285714,71
"6860","WI-593045",1998,136,82,10.1454005660377,54
"6861","WI-593045",1999,157,74,10.2438769512195,83
"6862","WI-593045",2000,163,53,9.31004495412844,110
"6863","WI-593045",2001,161,88,11.1366177777778,73
"6864","WI-593045",2002,172,95,11.3824701315789,77
"6865","WI-593045",2003,173,97,12.2932028,76
"6866","WI-593045",2004,193,81,12.3957246846847,112
"6867","WI-593045",2005,155,83,10.3041167605634,72
"6868","WI-593045",2006,146,83,9.60934548387097,63
"6869","WI-593045",2007,151,99,12.6789988235294,52
"6870","WI-593045",2008,160,85,9.75246378378378,75
"6871","WI-593045",2009,168,74,9.44954075268817,94
"6872","WI-593045",2010,143,65,8.75682558441559,78
"6873","WI-593045",2011,156,89,9.78929893939394,67
"6874","WI-593045",2012,168,67,12.310054,101
"6875","WI-593045",2013,165,93,10.710416056338,72
"6876","WI-593045",2014,170,88,11.273939382716,82
"6877","WI-593045",2015,174,86,12.194691954023,88
"6878","WI-593045",2016,146,97,9.78007979166667,49
"6879","WI-593045",2017,160,76,10.219423253012,84
"6880","WI-593045",2018,145,108,12.3324816666667,37
"6881","WI-593045",2019,176,79,10.1857980208333,97
"6882","WI-593045",2020,147,81,7.00505261538462,66
"6883","WI-593045",2021,140,67,7.92526958333333,73
"6884","WI-593045",2022,132,90,6.92224731707317,42
"6885","WI-593045",2023,150,80,9.28563463768116,70
"6886","WI-593072",1979,190,103,11.9575036046512,87
"6887","WI-593072",1980,175,91,11.3938645783133,84
"6888","WI-593072",1981,164,81,9.53333890243903,83
"6889","WI-593072",1982,185,102,13.0274015853659,83
"6890","WI-593072",1983,172,108,10.9645976190476,64
"6891","WI-593072",1984,193,92,12.2164845,101
"6892","WI-593072",1985,186,82,12.1343447572816,104
"6893","WI-593072",1986,176,84,11.8963973626374,92
"6894","WI-593072",1987,149,92,11.3303073214286,57
"6895","WI-593072",1988,150,83,8.95780772727273,67
"6896","WI-593072",1989,172,83,10.0007609090909,89
"6897","WI-593072",1990,166,86,10.1315378481013,80
"6898","WI-593072",1991,133,74,7.03500862068966,59
"6899","WI-593072",1992,235,85,12.924302147651,150
"6900","WI-593072",1993,186,81,10.3614845192308,105
"6901","WI-593072",1994,164,87,9.59763394736842,77
"6902","WI-593072",1995,167,97,10.2932353623188,70
"6903","WI-593072",1996,179,102,10.5469113157895,77
"6904","WI-593072",1997,172,102,10.34,70
"6905","WI-593072",1998,167,82,11.8334222619048,85
"6906","WI-593072",1999,157,83,10.7544993150685,74
"6907","WI-593072",2000,193,53,10.9139403597122,140
"6908","WI-593072",2001,162,88,10.8487424657534,74
"6909","WI-593072",2002,172,95,10.9068330263158,77
"6910","WI-593072",2003,174,97,11.9698067105263,77
"6911","WI-593072",2004,193,82,11.8787905454545,111
"6912","WI-593072",2005,155,83,9.83514633802817,72
"6913","WI-593072",2006,147,83,9.39805317460318,64
"6914","WI-593072",2007,151,99,12.3087460784314,52
"6915","WI-593072",2008,177,86,11.0420034444444,91
"6916","WI-593072",2009,169,74,9.08585819148936,95
"6917","WI-593072",2010,143,65,8.56851376623377,78
"6918","WI-593072",2011,156,89,9.39015121212121,67
"6919","WI-593072",2012,168,67,11.9383352,101
"6920","WI-593072",2013,173,93,11.132132278481,80
"6921","WI-593072",2014,176,88,11.4651802298851,88
"6922","WI-593072",2015,189,87,13.003704950495,102
"6923","WI-593072",2016,146,98,9.54100489361702,48
"6924","WI-593072",2017,160,76,9.85345867469879,84
"6925","WI-593072",2018,145,108,11.9568308333333,37
"6926","WI-593072",2019,177,82,10.0439115957447,95
"6927","WI-593072",2020,172,84,9.79997321839081,88
"6928","WI-593072",2021,142,67,7.82043824324324,75
"6929","WI-593072",2022,132,90,6.19358951219512,42
"6930","WI-593072",2023,151,81,9.19742869565217,70
"6931","WI-593076",1979,190,102,12.6718816091954,88
"6932","WI-593076",1980,175,88,11.7010038372093,87
"6933","WI-593076",1981,164,81,8.99199024390244,83
"6934","WI-593076",1982,185,102,13.222047195122,83
"6935","WI-593076",1983,172,108,11.0899701587302,64
"6936","WI-593076",1984,193,93,12.142566969697,100
"6937","WI-593076",1985,185,82,12.3153957843137,103
"6938","WI-593076",1986,176,84,12.2478742857143,92
"6939","WI-593076",1987,148,92,11.3767329090909,56
"6940","WI-593076",1988,150,83,9.12660484848485,67
"6941","WI-593076",1989,172,82,10.2389728089888,90
"6942","WI-593076",1990,166,85,10.192581625,81
"6943","WI-593076",1991,133,74,7.21954465517241,59
"6944","WI-593076",1992,221,84,12.5500141911765,137
"6945","WI-593076",1993,186,81,10.5891743269231,105
"6946","WI-593076",1994,164,78,9.14398223529412,86
"6947","WI-593076",1995,166,97,10.4614639705882,69
"6948","WI-593076",1996,179,100,10.6053674358974,79
"6949","WI-593076",1997,172,102,10.5779973913043,70
"6950","WI-593076",1998,166,82,11.9235792771084,84
"6951","WI-593076",1999,157,74,10.0337962195122,83
"6952","WI-593076",2000,185,53,10.6561383206107,132
"6953","WI-593076",2001,161,88,10.8900905555556,73
"6954","WI-593076",2002,172,95,11.1252748684211,77
"6955","WI-593076",2003,173,97,12.1810154666667,76
"6956","WI-593076",2004,193,81,12.1096884684685,112
"6957","WI-593076",2005,155,83,10.0699616901408,72
"6958","WI-593076",2006,146,83,9.37119048387097,63
"6959","WI-593076",2007,151,99,12.4910378431373,52
"6960","WI-593076",2008,176,86,11.0489682022472,90
"6961","WI-593076",2009,169,74,9.29205787234043,95
"6962","WI-593076",2010,143,65,8.6229987012987,78
"6963","WI-593076",2011,156,89,9.54474439393939,67
"6964","WI-593076",2012,168,67,12.0570066,101
"6965","WI-593076",2013,173,93,11.258516835443,80
"6966","WI-593076",2014,170,88,11.0411077777778,82
"6967","WI-593076",2015,175,86,12.0005736363636,89
"6968","WI-593076",2016,146,98,9.81261425531915,48
"6969","WI-593076",2017,160,76,10.0066037349398,84
"6970","WI-593076",2018,145,108,12.2057455555556,37
"6971","WI-593076",2019,177,79,10.0357856701031,98
"6972","WI-593076",2020,172,82,9.93021191011236,90
"6973","WI-593076",2021,141,67,7.88150712328767,74
"6974","WI-593076",2022,132,90,6.57297097560976,42
"6975","WI-593076",2023,150,80,9.05861913043478,70
"6976","WI-593121",1979,190,103,11.9575036046512,87
"6977","WI-593121",1980,175,91,11.3938645783133,84
"6978","WI-593121",1981,164,81,9.53333890243903,83
"6979","WI-593121",1982,185,102,13.0274015853659,83
"6980","WI-593121",1983,172,108,10.9645976190476,64
"6981","WI-593121",1984,193,92,12.2164845,101
"6982","WI-593121",1985,186,82,12.1343447572816,104
"6983","WI-593121",1986,176,84,11.8963973626374,92
"6984","WI-593121",1987,149,92,11.3303073214286,57
"6985","WI-593121",1988,150,83,8.95780772727273,67
"6986","WI-593121",1989,172,83,10.0007609090909,89
"6987","WI-593121",1990,166,86,10.1315378481013,80
"6988","WI-593121",1991,133,74,7.03500862068966,59
"6989","WI-593121",1992,235,85,12.924302147651,150
"6990","WI-593121",1993,186,81,10.3614845192308,105
"6991","WI-593121",1994,164,87,9.59763394736842,77
"6992","WI-593121",1995,167,97,10.2932353623188,70
"6993","WI-593121",1996,179,102,10.5469113157895,77
"6994","WI-593121",1997,172,102,10.34,70
"6995","WI-593121",1998,167,82,11.8334222619048,85
"6996","WI-593121",1999,157,83,10.7544993150685,74
"6997","WI-593121",2000,193,53,10.9139403597122,140
"6998","WI-593121",2001,162,88,10.8487424657534,74
"6999","WI-593121",2002,172,95,10.9068330263158,77
"7000","WI-593121",2003,174,97,11.9698067105263,77
"7001","WI-593121",2004,193,82,11.8787905454545,111
"7002","WI-593121",2005,155,83,9.83514633802817,72
"7003","WI-593121",2006,147,83,9.39805317460318,64
"7004","WI-593121",2007,151,99,12.3087460784314,52
"7005","WI-593121",2008,177,86,11.0420034444444,91
"7006","WI-593121",2009,169,74,9.08585819148936,95
"7007","WI-593121",2010,143,65,8.56851376623377,78
"7008","WI-593121",2011,156,89,9.39015121212121,67
"7009","WI-593121",2012,168,67,11.9383352,101
"7010","WI-593121",2013,173,93,11.132132278481,80
"7011","WI-593121",2014,176,88,11.4651802298851,88
"7012","WI-593121",2015,189,87,13.003704950495,102
"7013","WI-593121",2016,146,98,9.54100489361702,48
"7014","WI-593121",2017,160,76,9.85345867469879,84
"7015","WI-593121",2018,145,108,11.9568308333333,37
"7016","WI-593121",2019,177,82,10.0439115957447,95
"7017","WI-593121",2020,172,84,9.79997321839081,88
"7018","WI-593121",2021,142,67,7.82043824324324,75
"7019","WI-593121",2022,132,90,6.19358951219512,42
"7020","WI-593121",2023,151,81,9.19742869565217,70
"7021","WI-603312",1979,190,100,12.8956557303371,90
"7022","WI-603312",1980,175,86,11.5261001136364,89
"7023","WI-603312",1981,163,84,9.24208551282051,79
"7024","WI-603312",1982,185,102,14.1532591463415,83
"7025","WI-603312",1983,162,109,10.0018530769231,53
"7026","WI-603312",1984,156,92,9.2711073015873,64
"7027","WI-603312",1985,183,81,12.8426759405941,102
"7028","WI-603312",1986,172,83,12.2979267045455,89
"7029","WI-603312",1987,148,92,11.2723289090909,56
"7030","WI-603312",1988,150,81,9.05753117647059,69
"7031","WI-603312",1989,171,81,10.9876111235955,90
"7032","WI-603312",1990,165,83,10.3339708641975,82
"7033","WI-603312",1991,133,73,8.27650118644068,60
"7034","WI-603312",1992,191,81,11.3256300917431,110
"7035","WI-603312",1993,174,80,10.3517741935484,94
"7036","WI-603312",1994,164,76,9.65777517241379,88
"7037","WI-603312",1995,166,68,8.72687226804124,98
"7038","WI-603312",1996,179,98,11.20463725,81
"7039","WI-603312",1997,171,101,10.7108842028986,70
"7040","WI-603312",1998,136,81,9.94399277777778,55
"7041","WI-603312",1999,157,74,10.2700768292683,83
"7042","WI-603312",2000,163,51,9.57656405405405,112
"7043","WI-603312",2001,161,87,11.3434935616438,74
"7044","WI-603312",2002,171,86,10.6586727380952,85
"7045","WI-603312",2003,174,97,12.0815460526316,77
"7046","WI-603312",2004,192,75,12.6015342241379,117
"7047","WI-603312",2005,155,78,10.0886859210526,77
"7048","WI-603312",2006,147,80,9.89283984848485,67
"7049","WI-603312",2007,150,99,12.4871172,51
"7050","WI-603312",2008,157,74,8.65148634146341,83
"7051","WI-603312",2009,169,73,9.90066621052632,96
"7052","WI-603312",2010,144,65,9.03454205128205,79
"7053","WI-603312",2011,153,87,9.98330184615385,66
"7054","WI-603312",2012,166,57,11.5433116666667,109
"7055","WI-603312",2013,172,83,10.9043094318182,89
"7056","WI-603312",2014,168,86,11.6046191358025,82
"7057","WI-603312",2015,171,85,12.4693404705882,86
"7058","WI-603312",2016,146,64,8.06597172839506,82
"7059","WI-603312",2017,161,76,10.9101876190476,85
"7060","WI-603312",2018,145,97,9.88946446808511,48
"7061","WI-603312",2019,176,73,10.3431856862745,103
"7062","WI-603312",2020,146,66,6.75935050632911,80
"7063","WI-603312",2021,140,65,8.39582297297297,75
"7064","WI-603312",2022,132,88,7.72906325581395,44
"7065","WI-603312",2023,150,76,9.33383123287671,74
"7066","WI-643047",1979,190,124,8.96698907692308,66
"7067","WI-643047",1980,175,107,12.0504676119403,68
"7068","WI-643047",1981,185,96,11.1192511363636,89
"7069","WI-643047",1982,185,102,12.065987804878,83
"7070","WI-643047",1983,173,110,10.4749927419355,63
"7071","WI-643047",1984,193,101,10.9802272527473,92
"7072","WI-643047",1985,NA,99,NA,NA
"7073","WI-643047",1986,187,86,11.6198657,101
"7074","WI-643047",1987,150,93,11.2692278571429,57
"7075","WI-643047",1988,150,87,8.48664935483871,63
"7076","WI-643047",1989,183,102,11.584838875,81
"7077","WI-643047",1990,180,99,11.651389125,81
"7078","WI-643047",1991,177,91,12.7397698823529,86
"7079","WI-643047",1992,NA,105,NA,NA
"7080","WI-643047",1993,223,94,12.286562578125,129
"7081","WI-643047",1994,165,95,9.51084797101449,70
"7082","WI-643047",1995,167,99,9.01775910447761,68
"7083","WI-643047",1996,181,106,10.1698622972973,75
"7084","WI-643047",1997,173,104,9.50931926470588,69
"7085","WI-643047",1998,169,82,11.0672420930233,87
"7086","WI-643047",1999,158,86,10.0882097183099,72
"7087","WI-643047",2000,212,78,11.8476005263158,134
"7088","WI-643047",2001,163,89,9.90407726027397,74
"7089","WI-643047",2002,173,97,9.82342853333333,76
"7090","WI-643047",2003,183,98,12.0844335714286,85
"7091","WI-643047",2004,195,93,11.1007011881188,102
"7092","WI-643047",2005,157,85,9.49369183098591,72
"7093","WI-643047",2006,147,86,8.65195633333333,61
"7094","WI-643047",2007,163,101,13.0869363934426,62
"7095","WI-643047",2008,191,92,11.1984462244898,99
"7096","WI-643047",2009,170,98,10.1911776056338,72
"7097","WI-643047",2010,142,65,7.79681131578947,77
"7098","WI-643047",2011,180,90,10.5647612359551,90
"7099","WI-643047",2012,169,69,10.3365062626263,100
"7100","WI-643047",2013,173,108,11.72683296875,65
"7101","WI-643047",2014,177,107,12.4822436231884,70
"7102","WI-643047",2015,193,88,12.0730156730769,105
"7103","WI-643047",2016,188,101,13.5053260465116,87
"7104","WI-643047",2017,161,79,8.73033222222222,82
"7105","WI-643047",2018,145,109,11.0270794285714,36
"7106","WI-643047",2019,178,103,10.9125014864865,75
"7107","WI-643047",2020,179,111,12.2427250746269,68
"7108","WI-643047",2021,155,77,8.45442818181818,78
"7109","WI-643047",2022,169,109,12.1510822033898,60
"7110","WI-643047",2023,151,96,10.0944535185185,55
"7111","WI-643066",1979,190,122,8.6590623880597,68
"7112","WI-643066",1980,175,106,11.0088302941176,69
"7113","WI-643066",1981,185,95,10.887822247191,90
"7114","WI-643066",1982,185,102,12.1575462195122,83
"7115","WI-643066",1983,173,109,10.4955087301587,64
"7116","WI-643066",1984,193,101,11.1600013186813,92
"7117","WI-643066",1985,218,98,14.3910457983193,120
"7118","WI-643066",1986,187,86,11.8441623,101
"7119","WI-643066",1987,150,93,11.4404051785714,57
"7120","WI-643066",1988,150,86,8.44087063492064,64
"7121","WI-643066",1989,173,102,10.8133124285714,71
"7122","WI-643066",1990,179,99,11.7368237974684,80
"7123","WI-643066",1991,151,91,10.7587662711864,60
"7124","WI-643066",1992,NA,105,NA,NA
"7125","WI-643066",1993,222,94,12.3697165354331,128
"7126","WI-643066",1994,165,95,9.64943579710145,70
"7127","WI-643066",1995,167,98,9.07504720588235,69
"7128","WI-643066",1996,181,106,10.41944,75
"7129","WI-643066",1997,173,104,9.77459911764706,69
"7130","WI-643066",1998,169,82,11.2486558139535,87
"7131","WI-643066",1999,158,85,10.2323115277778,73
"7132","WI-643066",2000,193,78,11.1809405263158,115
"7133","WI-643066",2001,163,89,9.92762178082192,74
"7134","WI-643066",2002,173,97,9.98790786666667,76
"7135","WI-643066",2003,183,98,12.1720444047619,85
"7136","WI-643066",2004,194,93,11.192073,101
"7137","WI-643066",2005,157,85,9.62826464788732,72
"7138","WI-643066",2006,147,86,8.765628,61
"7139","WI-643066",2007,163,101,13.0795072131148,62
"7140","WI-643066",2008,191,92,11.2620621428571,99
"7141","WI-643066",2009,170,98,10.4287438028169,72
"7142","WI-643066",2010,142,66,7.95447573333333,76
"7143","WI-643066",2011,180,90,10.6927458426966,90
"7144","WI-643066",2012,169,69,10.4837593939394,100
"7145","WI-643066",2013,173,108,11.7973890625,65
"7146","WI-643066",2014,177,107,12.605091884058,70
"7147","WI-643066",2015,193,88,12.2332463461538,105
"7148","WI-643066",2016,188,101,13.6859224418605,87
"7149","WI-643066",2017,161,78,8.90568109756098,83
"7150","WI-643066",2018,145,109,11.0960525714286,36
"7151","WI-643066",2019,178,103,11.0351794594595,75
"7152","WI-643066",2020,179,109,12.1350063768116,70
"7153","WI-643066",2021,155,76,8.5075958974359,79
"7154","WI-643066",2022,169,108,12.1270781666667,61
"7155","WI-643066",2023,151,96,10.0972024074074,55
"7156","WI-643080",1979,191,124,8.97153363636364,67
"7157","WI-643080",1980,175,107,11.4314147761194,68
"7158","WI-643080",1981,185,97,10.7433573563218,88
"7159","WI-643080",1982,195,102,12.5921257608696,93
"7160","WI-643080",1983,173,110,10.1347708064516,63
"7161","WI-643080",1984,194,101,10.9359236956522,93
"7162","WI-643080",1985,NA,99,NA,NA
"7163","WI-643080",1986,188,86,10.9009788118812,102
"7164","WI-643080",1987,150,93,10.9660742857143,57
"7165","WI-643080",1988,150,89,8.44527866666667,61
"7166","WI-643080",1989,184,102,11.3640790123457,82
"7167","WI-643080",1990,182,100,11.8179172839506,82
"7168","WI-643080",1991,177,91,12.4994203529412,86
"7169","WI-643080",1992,NA,105,NA,NA
"7170","WI-643080",1993,223,94,11.987857109375,129
"7171","WI-643080",1994,166,96,9.5215768115942,70
"7172","WI-643080",1995,167,99,8.7224,68
"7173","WI-643080",1996,181,106,9.80362554054054,75
"7174","WI-643080",1997,174,105,9.46216617647059,69
"7175","WI-643080",1998,175,82,11.3444686956522,93
"7176","WI-643080",1999,158,86,9.7524923943662,72
"7177","WI-643080",2000,225,101,13.7603454471545,124
"7178","WI-643080",2001,163,89,9.69506643835616,74
"7179","WI-643080",2002,173,97,9.505616,76
"7180","WI-643080",2003,184,98,11.9319970588235,86
"7181","WI-643080",2004,195,94,10.8532355,101
"7182","WI-643080",2005,158,85,9.33315402777778,73
"7183","WI-643080",2006,147,86,8.44388366666667,61
"7184","WI-643080",2007,163,101,12.8359114754098,62
"7185","WI-643080",2008,200,92,11.5558091588785,108
"7186","WI-643080",2009,171,99,10.0109266197183,72
"7187","WI-643080",2010,142,65,7.63788855263158,77
"7188","WI-643080",2011,180,89,10.301323,91
"7189","WI-643080",2012,169,68,10.5393105,101
"7190","WI-643080",2013,174,108,11.6439503076923,66
"7191","WI-643080",2014,178,107,12.1997071428571,71
"7192","WI-643080",2015,194,97,12.7959385416667,97
"7193","WI-643080",2016,188,102,13.2851756470588,86
"7194","WI-643080",2017,161,83,8.97224753246753,78
"7195","WI-643080",2018,145,109,10.7985077142857,36
"7196","WI-643080",2019,179,103,10.7155446666667,76
"7197","WI-643080",2020,180,111,12.0902336764706,69
"7198","WI-643080",2021,155,77,8.18910727272727,78
"7199","WI-643080",2022,169,109,11.9227979661017,60
"7200","WI-643080",2023,151,97,9.95617264150943,54
"7201","WI-643088",1979,190,124,8.96698907692308,66
"7202","WI-643088",1980,175,107,12.0504676119403,68
"7203","WI-643088",1981,185,96,11.1192511363636,89
"7204","WI-643088",1982,185,102,12.065987804878,83
"7205","WI-643088",1983,173,110,10.4749927419355,63
"7206","WI-643088",1984,193,101,10.9802272527473,92
"7207","WI-643088",1985,NA,99,NA,NA
"7208","WI-643088",1986,187,86,11.6198657,101
"7209","WI-643088",1987,150,93,11.2692278571429,57
"7210","WI-643088",1988,150,87,8.48664935483871,63
"7211","WI-643088",1989,183,102,11.584838875,81
"7212","WI-643088",1990,180,99,11.651389125,81
"7213","WI-643088",1991,177,91,12.7397698823529,86
"7214","WI-643088",1992,NA,105,NA,NA
"7215","WI-643088",1993,223,94,12.286562578125,129
"7216","WI-643088",1994,165,95,9.51084797101449,70
"7217","WI-643088",1995,167,99,9.01775910447761,68
"7218","WI-643088",1996,181,106,10.1698622972973,75
"7219","WI-643088",1997,173,104,9.50931926470588,69
"7220","WI-643088",1998,169,82,11.0672420930233,87
"7221","WI-643088",1999,158,86,10.0882097183099,72
"7222","WI-643088",2000,212,78,11.8476005263158,134
"7223","WI-643088",2001,163,89,9.90407726027397,74
"7224","WI-643088",2002,173,97,9.82342853333333,76
"7225","WI-643088",2003,183,98,12.0844335714286,85
"7226","WI-643088",2004,195,93,11.1007011881188,102
"7227","WI-643088",2005,157,85,9.49369183098591,72
"7228","WI-643088",2006,147,86,8.65195633333333,61
"7229","WI-643088",2007,163,101,13.0869363934426,62
"7230","WI-643088",2008,191,92,11.1984462244898,99
"7231","WI-643088",2009,170,98,10.1911776056338,72
"7232","WI-643088",2010,142,65,7.79681131578947,77
"7233","WI-643088",2011,180,90,10.5647612359551,90
"7234","WI-643088",2012,169,69,10.3365062626263,100
"7235","WI-643088",2013,173,108,11.72683296875,65
"7236","WI-643088",2014,177,107,12.4822436231884,70
"7237","WI-643088",2015,193,88,12.0730156730769,105
"7238","WI-643088",2016,188,101,13.5053260465116,87
"7239","WI-643088",2017,161,79,8.73033222222222,82
"7240","WI-643088",2018,145,109,11.0270794285714,36
"7241","WI-643088",2019,178,103,10.9125014864865,75
"7242","WI-643088",2020,179,111,12.2427250746269,68
"7243","WI-643088",2021,155,77,8.45442818181818,78
"7244","WI-643088",2022,169,109,12.1510822033898,60
"7245","WI-643088",2023,151,96,10.0944535185185,55
"7246","WI-643095",1979,190,122,8.6590623880597,68
"7247","WI-643095",1980,175,106,11.0088302941176,69
"7248","WI-643095",1981,185,95,10.887822247191,90
"7249","WI-643095",1982,185,102,12.1575462195122,83
"7250","WI-643095",1983,173,109,10.4955087301587,64
"7251","WI-643095",1984,193,101,11.1600013186813,92
"7252","WI-643095",1985,218,98,14.3910457983193,120
"7253","WI-643095",1986,187,86,11.8441623,101
"7254","WI-643095",1987,150,93,11.4404051785714,57
"7255","WI-643095",1988,150,86,8.44087063492064,64
"7256","WI-643095",1989,173,102,10.8133124285714,71
"7257","WI-643095",1990,179,99,11.7368237974684,80
"7258","WI-643095",1991,151,91,10.7587662711864,60
"7259","WI-643095",1992,NA,105,NA,NA
"7260","WI-643095",1993,222,94,12.3697165354331,128
"7261","WI-643095",1994,165,95,9.64943579710145,70
"7262","WI-643095",1995,167,98,9.07504720588235,69
"7263","WI-643095",1996,181,106,10.41944,75
"7264","WI-643095",1997,173,104,9.77459911764706,69
"7265","WI-643095",1998,169,82,11.2486558139535,87
"7266","WI-643095",1999,158,85,10.2323115277778,73
"7267","WI-643095",2000,193,78,11.1809405263158,115
"7268","WI-643095",2001,163,89,9.92762178082192,74
"7269","WI-643095",2002,173,97,9.98790786666667,76
"7270","WI-643095",2003,183,98,12.1720444047619,85
"7271","WI-643095",2004,194,93,11.192073,101
"7272","WI-643095",2005,157,85,9.62826464788732,72
"7273","WI-643095",2006,147,86,8.765628,61
"7274","WI-643095",2007,163,101,13.0795072131148,62
"7275","WI-643095",2008,191,92,11.2620621428571,99
"7276","WI-643095",2009,170,98,10.4287438028169,72
"7277","WI-643095",2010,142,66,7.95447573333333,76
"7278","WI-643095",2011,180,90,10.6927458426966,90
"7279","WI-643095",2012,169,69,10.4837593939394,100
"7280","WI-643095",2013,173,108,11.7973890625,65
"7281","WI-643095",2014,177,107,12.605091884058,70
"7282","WI-643095",2015,193,88,12.2332463461538,105
"7283","WI-643095",2016,188,101,13.6859224418605,87
"7284","WI-643095",2017,161,78,8.90568109756098,83
"7285","WI-643095",2018,145,109,11.0960525714286,36
"7286","WI-643095",2019,178,103,11.0351794594595,75
"7287","WI-643095",2020,179,109,12.1350063768116,70
"7288","WI-643095",2021,155,76,8.5075958974359,79
"7289","WI-643095",2022,169,108,12.1270781666667,61
"7290","WI-643095",2023,151,96,10.0972024074074,55
"7291","WI-643125",1979,191,124,8.97153363636364,67
"7292","WI-643125",1980,175,107,11.4314147761194,68
"7293","WI-643125",1981,185,97,10.7433573563218,88
"7294","WI-643125",1982,195,102,12.5921257608696,93
"7295","WI-643125",1983,173,110,10.1347708064516,63
"7296","WI-643125",1984,194,101,10.9359236956522,93
"7297","WI-643125",1985,NA,99,NA,NA
"7298","WI-643125",1986,188,86,10.9009788118812,102
"7299","WI-643125",1987,150,93,10.9660742857143,57
"7300","WI-643125",1988,150,89,8.44527866666667,61
"7301","WI-643125",1989,184,102,11.3640790123457,82
"7302","WI-643125",1990,182,100,11.8179172839506,82
"7303","WI-643125",1991,177,91,12.4994203529412,86
"7304","WI-643125",1992,NA,105,NA,NA
"7305","WI-643125",1993,223,94,11.987857109375,129
"7306","WI-643125",1994,166,96,9.5215768115942,70
"7307","WI-643125",1995,167,99,8.7224,68
"7308","WI-643125",1996,181,106,9.80362554054054,75
"7309","WI-643125",1997,174,105,9.46216617647059,69
"7310","WI-643125",1998,175,82,11.3444686956522,93
"7311","WI-643125",1999,158,86,9.7524923943662,72
"7312","WI-643125",2000,225,101,13.7603454471545,124
"7313","WI-643125",2001,163,89,9.69506643835616,74
"7314","WI-643125",2002,173,97,9.505616,76
"7315","WI-643125",2003,184,98,11.9319970588235,86
"7316","WI-643125",2004,195,94,10.8532355,101
"7317","WI-643125",2005,158,85,9.33315402777778,73
"7318","WI-643125",2006,147,86,8.44388366666667,61
"7319","WI-643125",2007,163,101,12.8359114754098,62
"7320","WI-643125",2008,200,92,11.5558091588785,108
"7321","WI-643125",2009,171,99,10.0109266197183,72
"7322","WI-643125",2010,142,65,7.63788855263158,77
"7323","WI-643125",2011,180,89,10.301323,91
"7324","WI-643125",2012,169,68,10.5393105,101
"7325","WI-643125",2013,174,108,11.6439503076923,66
"7326","WI-643125",2014,178,107,12.1997071428571,71
"7327","WI-643125",2015,194,97,12.7959385416667,97
"7328","WI-643125",2016,188,102,13.2851756470588,86
"7329","WI-643125",2017,161,83,8.97224753246753,78
"7330","WI-643125",2018,145,109,10.7985077142857,36
"7331","WI-643125",2019,179,103,10.7155446666667,76
"7332","WI-643125",2020,180,111,12.0902336764706,69
"7333","WI-643125",2021,155,77,8.18910727272727,78
"7334","WI-643125",2022,169,109,11.9227979661017,60
"7335","WI-643125",2023,151,97,9.95617264150943,54
"7336","WI-643126",1979,190,124,9.44703830769231,66
"7337","WI-643126",1980,175,107,10.9519379104478,68
"7338","WI-643126",1981,185,97,10.8105272413793,88
"7339","WI-643126",1982,187,102,12.0194495238095,85
"7340","WI-643126",1983,173,110,10.2862322580645,63
"7341","WI-643126",1984,193,101,11.0820476923077,92
"7342","WI-643126",1985,NA,99,NA,NA
"7343","WI-643126",1986,188,86,11.3826465346535,102
"7344","WI-643126",1987,150,93,11.1044671428571,57
"7345","WI-643126",1988,150,89,8.621971,61
"7346","WI-643126",1989,184,102,11.4527172839506,82
"7347","WI-643126",1990,182,100,11.8683607407407,82
"7348","WI-643126",1991,177,91,12.5519028235294,86
"7349","WI-643126",1992,NA,105,NA,NA
"7350","WI-643126",1993,223,94,12.071902578125,129
"7351","WI-643126",1994,166,96,9.52927594202898,70
"7352","WI-643126",1995,167,99,8.83434059701493,68
"7353","WI-643126",1996,181,106,9.98943594594595,75
"7354","WI-643126",1997,174,104,9.50023768115942,70
"7355","WI-643126",1998,176,82,11.5029579569892,94
"7356","WI-643126",1999,158,86,9.85295478873239,72
"7357","WI-643126",2000,225,78,12.2486180821918,147
"7358","WI-643126",2001,163,89,9.7114401369863,74
"7359","WI-643126",2002,173,97,9.528742,76
"7360","WI-643126",2003,184,98,12.0026769411765,86
"7361","WI-643126",2004,195,93,10.8013508910891,102
"7362","WI-643126",2005,159,85,9.51996301369863,74
"7363","WI-643126",2006,147,86,8.50117516666667,61
"7364","WI-643126",2007,163,101,12.7886521311475,62
"7365","WI-643126",2008,199,103,12.4028904210526,96
"7366","WI-643126",2009,170,99,10.0155901428571,71
"7367","WI-643126",2010,142,86,8.77634581818182,56
"7368","WI-643126",2011,180,108,11.8676670422535,72
"7369","WI-643126",2012,170,69,10.1651256,101
"7370","WI-643126",2013,174,109,11.70137296875,65
"7371","WI-643126",2014,178,107,12.2343052857143,71
"7372","WI-643126",2015,193,88,11.9076761538462,105
"7373","WI-643126",2016,190,102,13.6465120689655,88
"7374","WI-643126",2017,162,83,9.18997538461539,79
"7375","WI-643126",2018,145,109,10.9228385714286,36
"7376","WI-643126",2019,179,103,10.7527321333333,76
"7377","WI-643126",2020,179,110,12.0052345588235,69
"7378","WI-643126",2021,155,77,8.15816207792208,78
"7379","WI-643126",2022,169,109,11.8947255932203,60
"7380","WI-643126",2023,151,97,9.86065377358491,54
"7381","WI-643137",1979,190,124,8.96698907692308,66
"7382","WI-643137",1980,175,107,12.0504676119403,68
"7383","WI-643137",1981,185,96,11.1192511363636,89
"7384","WI-643137",1982,185,102,12.065987804878,83
"7385","WI-643137",1983,173,110,10.4749927419355,63
"7386","WI-643137",1984,193,101,10.9802272527473,92
"7387","WI-643137",1985,NA,99,NA,NA
"7388","WI-643137",1986,187,86,11.6198657,101
"7389","WI-643137",1987,150,93,11.2692278571429,57
"7390","WI-643137",1988,150,87,8.48664935483871,63
"7391","WI-643137",1989,183,102,11.584838875,81
"7392","WI-643137",1990,180,99,11.651389125,81
"7393","WI-643137",1991,177,91,12.7397698823529,86
"7394","WI-643137",1992,NA,105,NA,NA
"7395","WI-643137",1993,223,94,12.286562578125,129
"7396","WI-643137",1994,165,95,9.51084797101449,70
"7397","WI-643137",1995,167,99,9.01775910447761,68
"7398","WI-643137",1996,181,106,10.1698622972973,75
"7399","WI-643137",1997,173,104,9.50931926470588,69
"7400","WI-643137",1998,169,82,11.0672420930233,87
"7401","WI-643137",1999,158,86,10.0882097183099,72
"7402","WI-643137",2000,212,78,11.8476005263158,134
"7403","WI-643137",2001,163,89,9.90407726027397,74
"7404","WI-643137",2002,173,97,9.82342853333333,76
"7405","WI-643137",2003,183,98,12.0844335714286,85
"7406","WI-643137",2004,195,93,11.1007011881188,102
"7407","WI-643137",2005,157,85,9.49369183098591,72
"7408","WI-643137",2006,147,86,8.65195633333333,61
"7409","WI-643137",2007,163,101,13.0869363934426,62
"7410","WI-643137",2008,191,92,11.1984462244898,99
"7411","WI-643137",2009,170,98,10.1911776056338,72
"7412","WI-643137",2010,142,65,7.79681131578947,77
"7413","WI-643137",2011,180,90,10.5647612359551,90
"7414","WI-643137",2012,169,69,10.3365062626263,100
"7415","WI-643137",2013,173,108,11.72683296875,65
"7416","WI-643137",2014,177,107,12.4822436231884,70
"7417","WI-643137",2015,193,88,12.0730156730769,105
"7418","WI-643137",2016,188,101,13.5053260465116,87
"7419","WI-643137",2017,161,79,8.73033222222222,82
"7420","WI-643137",2018,145,109,11.0270794285714,36
"7421","WI-643137",2019,178,103,10.9125014864865,75
"7422","WI-643137",2020,179,111,12.2427250746269,68
"7423","WI-643137",2021,155,77,8.45442818181818,78
"7424","WI-643137",2022,169,109,12.1510822033898,60
"7425","WI-643137",2023,151,96,10.0944535185185,55
"7426","WI-643239",1979,190,122,8.6590623880597,68
"7427","WI-643239",1980,175,106,11.0088302941176,69
"7428","WI-643239",1981,185,95,10.887822247191,90
"7429","WI-643239",1982,185,102,12.1575462195122,83
"7430","WI-643239",1983,173,109,10.4955087301587,64
"7431","WI-643239",1984,193,101,11.1600013186813,92
"7432","WI-643239",1985,218,98,14.3910457983193,120
"7433","WI-643239",1986,187,86,11.8441623,101
"7434","WI-643239",1987,150,93,11.4404051785714,57
"7435","WI-643239",1988,150,86,8.44087063492064,64
"7436","WI-643239",1989,173,102,10.8133124285714,71
"7437","WI-643239",1990,179,99,11.7368237974684,80
"7438","WI-643239",1991,151,91,10.7587662711864,60
"7439","WI-643239",1992,NA,105,NA,NA
"7440","WI-643239",1993,222,94,12.3697165354331,128
"7441","WI-643239",1994,165,95,9.64943579710145,70
"7442","WI-643239",1995,167,98,9.07504720588235,69
"7443","WI-643239",1996,181,106,10.41944,75
"7444","WI-643239",1997,173,104,9.77459911764706,69
"7445","WI-643239",1998,169,82,11.2486558139535,87
"7446","WI-643239",1999,158,85,10.2323115277778,73
"7447","WI-643239",2000,193,78,11.1809405263158,115
"7448","WI-643239",2001,163,89,9.92762178082192,74
"7449","WI-643239",2002,173,97,9.98790786666667,76
"7450","WI-643239",2003,183,98,12.1720444047619,85
"7451","WI-643239",2004,194,93,11.192073,101
"7452","WI-643239",2005,157,85,9.62826464788732,72
"7453","WI-643239",2006,147,86,8.765628,61
"7454","WI-643239",2007,163,101,13.0795072131148,62
"7455","WI-643239",2008,191,92,11.2620621428571,99
"7456","WI-643239",2009,170,98,10.4287438028169,72
"7457","WI-643239",2010,142,66,7.95447573333333,76
"7458","WI-643239",2011,180,90,10.6927458426966,90
"7459","WI-643239",2012,169,69,10.4837593939394,100
"7460","WI-643239",2013,173,108,11.7973890625,65
"7461","WI-643239",2014,177,107,12.605091884058,70
"7462","WI-643239",2015,193,88,12.2332463461538,105
"7463","WI-643239",2016,188,101,13.6859224418605,87
"7464","WI-643239",2017,161,78,8.90568109756098,83
"7465","WI-643239",2018,145,109,11.0960525714286,36
"7466","WI-643239",2019,178,103,11.0351794594595,75
"7467","WI-643239",2020,179,109,12.1350063768116,70
"7468","WI-643239",2021,155,76,8.5075958974359,79
"7469","WI-643239",2022,169,108,12.1270781666667,61
"7470","WI-643239",2023,151,96,10.0972024074074,55
"7471","WI-643273",1979,190,124,9.44703830769231,66
"7472","WI-643273",1980,175,107,10.9519379104478,68
"7473","WI-643273",1981,185,97,10.8105272413793,88
"7474","WI-643273",1982,187,102,12.0194495238095,85
"7475","WI-643273",1983,173,110,10.2862322580645,63
"7476","WI-643273",1984,193,101,11.0820476923077,92
"7477","WI-643273",1985,NA,99,NA,NA
"7478","WI-643273",1986,188,86,11.3826465346535,102
"7479","WI-643273",1987,150,93,11.1044671428571,57
"7480","WI-643273",1988,150,89,8.621971,61
"7481","WI-643273",1989,184,102,11.4527172839506,82
"7482","WI-643273",1990,182,100,11.8683607407407,82
"7483","WI-643273",1991,177,91,12.5519028235294,86
"7484","WI-643273",1992,NA,105,NA,NA
"7485","WI-643273",1993,223,94,12.071902578125,129
"7486","WI-643273",1994,166,96,9.52927594202898,70
"7487","WI-643273",1995,167,99,8.83434059701493,68
"7488","WI-643273",1996,181,106,9.98943594594595,75
"7489","WI-643273",1997,174,104,9.50023768115942,70
"7490","WI-643273",1998,176,82,11.5029579569892,94
"7491","WI-643273",1999,158,86,9.85295478873239,72
"7492","WI-643273",2000,225,78,12.2486180821918,147
"7493","WI-643273",2001,163,89,9.7114401369863,74
"7494","WI-643273",2002,173,97,9.528742,76
"7495","WI-643273",2003,184,98,12.0026769411765,86
"7496","WI-643273",2004,195,93,10.8013508910891,102
"7497","WI-643273",2005,159,85,9.51996301369863,74
"7498","WI-643273",2006,147,86,8.50117516666667,61
"7499","WI-643273",2007,163,101,12.7886521311475,62
"7500","WI-643273",2008,199,103,12.4028904210526,96
"7501","WI-643273",2009,170,99,10.0155901428571,71
"7502","WI-643273",2010,142,86,8.77634581818182,56
"7503","WI-643273",2011,180,108,11.8676670422535,72
"7504","WI-643273",2012,170,69,10.1651256,101
"7505","WI-643273",2013,174,109,11.70137296875,65
"7506","WI-643273",2014,178,107,12.2343052857143,71
"7507","WI-643273",2015,193,88,11.9076761538462,105
"7508","WI-643273",2016,190,102,13.6465120689655,88
"7509","WI-643273",2017,162,83,9.18997538461539,79
"7510","WI-643273",2018,145,109,10.9228385714286,36
"7511","WI-643273",2019,179,103,10.7527321333333,76
"7512","WI-643273",2020,179,110,12.0052345588235,69
"7513","WI-643273",2021,155,77,8.15816207792208,78
"7514","WI-643273",2022,169,109,11.8947255932203,60
"7515","WI-643273",2023,151,97,9.86065377358491,54
"7516","WI-643401",1979,190,123,9.27550424242424,67
"7517","WI-643401",1980,175,107,12.2169789552239,68
"7518","WI-643401",1981,185,94,10.9526598888889,91
"7519","WI-643401",1982,186,102,12.30282,84
"7520","WI-643401",1983,173,110,10.5649625806452,63
"7521","WI-643401",1984,193,101,11.1549350549451,92
"7522","WI-643401",1985,218,99,14.5675772881356,119
"7523","WI-643401",1986,187,86,11.7986157,101
"7524","WI-643401",1987,150,93,11.3681392857143,57
"7525","WI-643401",1988,150,86,8.39573174603175,64
"7526","WI-643401",1989,172,102,10.696971884058,70
"7527","WI-643401",1990,180,99,11.81574475,81
"7528","WI-643401",1991,150,91,10.5253972413793,59
"7529","WI-643401",1992,NA,105,NA,NA
"7530","WI-643401",1993,222,94,12.3352075590551,128
"7531","WI-643401",1994,165,95,9.66721144927536,70
"7532","WI-643401",1995,167,98,9.04092397058823,69
"7533","WI-643401",1996,181,106,10.3119651351351,75
"7534","WI-643401",1997,173,104,9.64902544117647,69
"7535","WI-643401",1998,169,82,11.2465665116279,87
"7536","WI-643401",1999,158,86,10.3031087323944,72
"7537","WI-643401",2000,224,78,12.6345162068966,146
"7538","WI-643401",2001,162,89,9.88265152777778,73
"7539","WI-643401",2002,173,97,10.0094702666667,76
"7540","WI-643401",2003,183,98,12.1818104761905,85
"7541","WI-643401",2004,195,93,11.2915266336634,102
"7542","WI-643401",2005,156,85,9.42306157142857,71
"7543","WI-643401",2006,147,86,8.75026333333333,61
"7544","WI-643401",2007,163,101,13.2069418032787,62
"7545","WI-643401",2008,191,92,11.4064337755102,99
"7546","WI-643401",2009,170,98,10.3929821126761,72
"7547","WI-643401",2010,142,65,7.91626026315789,77
"7548","WI-643401",2011,157,90,8.70533060606061,67
"7549","WI-643401",2012,169,68,10.3409509,101
"7550","WI-643401",2013,173,104,11.3824938235294,69
"7551","WI-643401",2014,177,107,12.6806131884058,70
"7552","WI-643401",2015,193,88,12.1664646153846,105
"7553","WI-643401",2016,188,101,13.6019837209302,87
"7554","WI-643401",2017,161,78,8.84727829268293,83
"7555","WI-643401",2018,145,109,11.2163648571429,36
"7556","WI-643401",2019,178,103,11.1356860810811,75
"7557","WI-643401",2020,179,111,12.3406734328358,68
"7558","WI-643401",2021,155,76,8.59794012820513,79
"7559","WI-643401",2022,169,109,12.3724794915254,60
"7560","WI-643401",2023,151,95,10.0410343636364,56
"7561","WI-643407",1979,190,124,9.44703830769231,66
"7562","WI-643407",1980,175,107,10.9519379104478,68
"7563","WI-643407",1981,185,97,10.8105272413793,88
"7564","WI-643407",1982,187,102,12.0194495238095,85
"7565","WI-643407",1983,173,110,10.2862322580645,63
"7566","WI-643407",1984,193,101,11.0820476923077,92
"7567","WI-643407",1985,NA,99,NA,NA
"7568","WI-643407",1986,188,86,11.3826465346535,102
"7569","WI-643407",1987,150,93,11.1044671428571,57
"7570","WI-643407",1988,150,89,8.621971,61
"7571","WI-643407",1989,184,102,11.4527172839506,82
"7572","WI-643407",1990,182,100,11.8683607407407,82
"7573","WI-643407",1991,177,91,12.5519028235294,86
"7574","WI-643407",1992,NA,105,NA,NA
"7575","WI-643407",1993,223,94,12.071902578125,129
"7576","WI-643407",1994,166,96,9.52927594202898,70
"7577","WI-643407",1995,167,99,8.83434059701493,68
"7578","WI-643407",1996,181,106,9.98943594594595,75
"7579","WI-643407",1997,174,104,9.50023768115942,70
"7580","WI-643407",1998,176,82,11.5029579569892,94
"7581","WI-643407",1999,158,86,9.85295478873239,72
"7582","WI-643407",2000,225,78,12.2486180821918,147
"7583","WI-643407",2001,163,89,9.7114401369863,74
"7584","WI-643407",2002,173,97,9.528742,76
"7585","WI-643407",2003,184,98,12.0026769411765,86
"7586","WI-643407",2004,195,93,10.8013508910891,102
"7587","WI-643407",2005,159,85,9.51996301369863,74
"7588","WI-643407",2006,147,86,8.50117516666667,61
"7589","WI-643407",2007,163,101,12.7886521311475,62
"7590","WI-643407",2008,199,103,12.4028904210526,96
"7591","WI-643407",2009,170,99,10.0155901428571,71
"7592","WI-643407",2010,142,86,8.77634581818182,56
"7593","WI-643407",2011,180,108,11.8676670422535,72
"7594","WI-643407",2012,170,69,10.1651256,101
"7595","WI-643407",2013,174,109,11.70137296875,65
"7596","WI-643407",2014,178,107,12.2343052857143,71
"7597","WI-643407",2015,193,88,11.9076761538462,105
"7598","WI-643407",2016,190,102,13.6465120689655,88
"7599","WI-643407",2017,162,83,9.18997538461539,79
"7600","WI-643407",2018,145,109,10.9228385714286,36
"7601","WI-643407",2019,179,103,10.7527321333333,76
"7602","WI-643407",2020,179,110,12.0052345588235,69
"7603","WI-643407",2021,155,77,8.15816207792208,78
"7604","WI-643407",2022,169,109,11.8947255932203,60
"7605","WI-643407",2023,151,97,9.86065377358491,54
"7606","WI-643444",1979,190,124,9.44703830769231,66
"7607","WI-643444",1980,175,107,10.9519379104478,68
"7608","WI-643444",1981,185,97,10.8105272413793,88
"7609","WI-643444",1982,187,102,12.0194495238095,85
"7610","WI-643444",1983,173,110,10.2862322580645,63
"7611","WI-643444",1984,193,101,11.0820476923077,92
"7612","WI-643444",1985,NA,99,NA,NA
"7613","WI-643444",1986,188,86,11.3826465346535,102
"7614","WI-643444",1987,150,93,11.1044671428571,57
"7615","WI-643444",1988,150,89,8.621971,61
"7616","WI-643444",1989,184,102,11.4527172839506,82
"7617","WI-643444",1990,182,100,11.8683607407407,82
"7618","WI-643444",1991,177,91,12.5519028235294,86
"7619","WI-643444",1992,NA,105,NA,NA
"7620","WI-643444",1993,223,94,12.071902578125,129
"7621","WI-643444",1994,166,96,9.52927594202898,70
"7622","WI-643444",1995,167,99,8.83434059701493,68
"7623","WI-643444",1996,181,106,9.98943594594595,75
"7624","WI-643444",1997,174,104,9.50023768115942,70
"7625","WI-643444",1998,176,82,11.5029579569892,94
"7626","WI-643444",1999,158,86,9.85295478873239,72
"7627","WI-643444",2000,225,78,12.2486180821918,147
"7628","WI-643444",2001,163,89,9.7114401369863,74
"7629","WI-643444",2002,173,97,9.528742,76
"7630","WI-643444",2003,184,98,12.0026769411765,86
"7631","WI-643444",2004,195,93,10.8013508910891,102
"7632","WI-643444",2005,159,85,9.51996301369863,74
"7633","WI-643444",2006,147,86,8.50117516666667,61
"7634","WI-643444",2007,163,101,12.7886521311475,62
"7635","WI-643444",2008,199,103,12.4028904210526,96
"7636","WI-643444",2009,170,99,10.0155901428571,71
"7637","WI-643444",2010,142,86,8.77634581818182,56
"7638","WI-643444",2011,180,108,11.8676670422535,72
"7639","WI-643444",2012,170,69,10.1651256,101
"7640","WI-643444",2013,174,109,11.70137296875,65
"7641","WI-643444",2014,178,107,12.2343052857143,71
"7642","WI-643444",2015,193,88,11.9076761538462,105
"7643","WI-643444",2016,190,102,13.6465120689655,88
"7644","WI-643444",2017,162,83,9.18997538461539,79
"7645","WI-643444",2018,145,109,10.9228385714286,36
"7646","WI-643444",2019,179,103,10.7527321333333,76
"7647","WI-643444",2020,179,110,12.0052345588235,69
"7648","WI-643444",2021,155,77,8.15816207792208,78
"7649","WI-643444",2022,169,109,11.8947255932203,60
"7650","WI-643444",2023,151,97,9.86065377358491,54
"7651","WI-643451",1979,190,123,9.27550424242424,67
"7652","WI-643451",1980,175,107,12.2169789552239,68
"7653","WI-643451",1981,185,94,10.9526598888889,91
"7654","WI-643451",1982,186,102,12.30282,84
"7655","WI-643451",1983,173,110,10.5649625806452,63
"7656","WI-643451",1984,193,101,11.1549350549451,92
"7657","WI-643451",1985,218,99,14.5675772881356,119
"7658","WI-643451",1986,187,86,11.7986157,101
"7659","WI-643451",1987,150,93,11.3681392857143,57
"7660","WI-643451",1988,150,86,8.39573174603175,64
"7661","WI-643451",1989,172,102,10.696971884058,70
"7662","WI-643451",1990,180,99,11.81574475,81
"7663","WI-643451",1991,150,91,10.5253972413793,59
"7664","WI-643451",1992,NA,105,NA,NA
"7665","WI-643451",1993,222,94,12.3352075590551,128
"7666","WI-643451",1994,165,95,9.66721144927536,70
"7667","WI-643451",1995,167,98,9.04092397058823,69
"7668","WI-643451",1996,181,106,10.3119651351351,75
"7669","WI-643451",1997,173,104,9.64902544117647,69
"7670","WI-643451",1998,169,82,11.2465665116279,87
"7671","WI-643451",1999,158,86,10.3031087323944,72
"7672","WI-643451",2000,224,78,12.6345162068966,146
"7673","WI-643451",2001,162,89,9.88265152777778,73
"7674","WI-643451",2002,173,97,10.0094702666667,76
"7675","WI-643451",2003,183,98,12.1818104761905,85
"7676","WI-643451",2004,195,93,11.2915266336634,102
"7677","WI-643451",2005,156,85,9.42306157142857,71
"7678","WI-643451",2006,147,86,8.75026333333333,61
"7679","WI-643451",2007,163,101,13.2069418032787,62
"7680","WI-643451",2008,191,92,11.4064337755102,99
"7681","WI-643451",2009,170,98,10.3929821126761,72
"7682","WI-643451",2010,142,65,7.91626026315789,77
"7683","WI-643451",2011,157,90,8.70533060606061,67
"7684","WI-643451",2012,169,68,10.3409509,101
"7685","WI-643451",2013,173,104,11.3824938235294,69
"7686","WI-643451",2014,177,107,12.6806131884058,70
"7687","WI-643451",2015,193,88,12.1664646153846,105
"7688","WI-643451",2016,188,101,13.6019837209302,87
"7689","WI-643451",2017,161,78,8.84727829268293,83
"7690","WI-643451",2018,145,109,11.2163648571429,36
"7691","WI-643451",2019,178,103,11.1356860810811,75
"7692","WI-643451",2020,179,111,12.3406734328358,68
"7693","WI-643451",2021,155,76,8.59794012820513,79
"7694","WI-643451",2022,169,109,12.3724794915254,60
"7695","WI-643451",2023,151,95,10.0410343636364,56
"7696","WI-643460",1979,190,124,8.96698907692308,66
"7697","WI-643460",1980,175,107,12.0504676119403,68
"7698","WI-643460",1981,185,96,11.1192511363636,89
"7699","WI-643460",1982,185,102,12.065987804878,83
"7700","WI-643460",1983,173,110,10.4749927419355,63
"7701","WI-643460",1984,193,101,10.9802272527473,92
"7702","WI-643460",1985,NA,99,NA,NA
"7703","WI-643460",1986,187,86,11.6198657,101
"7704","WI-643460",1987,150,93,11.2692278571429,57
"7705","WI-643460",1988,150,87,8.48664935483871,63
"7706","WI-643460",1989,183,102,11.584838875,81
"7707","WI-643460",1990,180,99,11.651389125,81
"7708","WI-643460",1991,177,91,12.7397698823529,86
"7709","WI-643460",1992,NA,105,NA,NA
"7710","WI-643460",1993,223,94,12.286562578125,129
"7711","WI-643460",1994,165,95,9.51084797101449,70
"7712","WI-643460",1995,167,99,9.01775910447761,68
"7713","WI-643460",1996,181,106,10.1698622972973,75
"7714","WI-643460",1997,173,104,9.50931926470588,69
"7715","WI-643460",1998,169,82,11.0672420930233,87
"7716","WI-643460",1999,158,86,10.0882097183099,72
"7717","WI-643460",2000,212,78,11.8476005263158,134
"7718","WI-643460",2001,163,89,9.90407726027397,74
"7719","WI-643460",2002,173,97,9.82342853333333,76
"7720","WI-643460",2003,183,98,12.0844335714286,85
"7721","WI-643460",2004,195,93,11.1007011881188,102
"7722","WI-643460",2005,157,85,9.49369183098591,72
"7723","WI-643460",2006,147,86,8.65195633333333,61
"7724","WI-643460",2007,163,101,13.0869363934426,62
"7725","WI-643460",2008,191,92,11.1984462244898,99
"7726","WI-643460",2009,170,98,10.1911776056338,72
"7727","WI-643460",2010,142,65,7.79681131578947,77
"7728","WI-643460",2011,180,90,10.5647612359551,90
"7729","WI-643460",2012,169,69,10.3365062626263,100
"7730","WI-643460",2013,173,108,11.72683296875,65
"7731","WI-643460",2014,177,107,12.4822436231884,70
"7732","WI-643460",2015,193,88,12.0730156730769,105
"7733","WI-643460",2016,188,101,13.5053260465116,87
"7734","WI-643460",2017,161,79,8.73033222222222,82
"7735","WI-643460",2018,145,109,11.0270794285714,36
"7736","WI-643460",2019,178,103,10.9125014864865,75
"7737","WI-643460",2020,179,111,12.2427250746269,68
"7738","WI-643460",2021,155,77,8.45442818181818,78
"7739","WI-643460",2022,169,109,12.1510822033898,60
"7740","WI-643460",2023,151,96,10.0944535185185,55
"7741","WI-643466",1979,190,123,9.27550424242424,67
"7742","WI-643466",1980,175,107,12.2169789552239,68
"7743","WI-643466",1981,185,94,10.9526598888889,91
"7744","WI-643466",1982,186,102,12.30282,84
"7745","WI-643466",1983,173,110,10.5649625806452,63
"7746","WI-643466",1984,193,101,11.1549350549451,92
"7747","WI-643466",1985,218,99,14.5675772881356,119
"7748","WI-643466",1986,187,86,11.7986157,101
"7749","WI-643466",1987,150,93,11.3681392857143,57
"7750","WI-643466",1988,150,86,8.39573174603175,64
"7751","WI-643466",1989,172,102,10.696971884058,70
"7752","WI-643466",1990,180,99,11.81574475,81
"7753","WI-643466",1991,150,91,10.5253972413793,59
"7754","WI-643466",1992,NA,105,NA,NA
"7755","WI-643466",1993,222,94,12.3352075590551,128
"7756","WI-643466",1994,165,95,9.66721144927536,70
"7757","WI-643466",1995,167,98,9.04092397058823,69
"7758","WI-643466",1996,181,106,10.3119651351351,75
"7759","WI-643466",1997,173,104,9.64902544117647,69
"7760","WI-643466",1998,169,82,11.2465665116279,87
"7761","WI-643466",1999,158,86,10.3031087323944,72
"7762","WI-643466",2000,224,78,12.6345162068966,146
"7763","WI-643466",2001,162,89,9.88265152777778,73
"7764","WI-643466",2002,173,97,10.0094702666667,76
"7765","WI-643466",2003,183,98,12.1818104761905,85
"7766","WI-643466",2004,195,93,11.2915266336634,102
"7767","WI-643466",2005,156,85,9.42306157142857,71
"7768","WI-643466",2006,147,86,8.75026333333333,61
"7769","WI-643466",2007,163,101,13.2069418032787,62
"7770","WI-643466",2008,191,92,11.4064337755102,99
"7771","WI-643466",2009,170,98,10.3929821126761,72
"7772","WI-643466",2010,142,65,7.91626026315789,77
"7773","WI-643466",2011,157,90,8.70533060606061,67
"7774","WI-643466",2012,169,68,10.3409509,101
"7775","WI-643466",2013,173,104,11.3824938235294,69
"7776","WI-643466",2014,177,107,12.6806131884058,70
"7777","WI-643466",2015,193,88,12.1664646153846,105
"7778","WI-643466",2016,188,101,13.6019837209302,87
"7779","WI-643466",2017,161,78,8.84727829268293,83
"7780","WI-643466",2018,145,109,11.2163648571429,36
"7781","WI-643466",2019,178,103,11.1356860810811,75
"7782","WI-643466",2020,179,111,12.3406734328358,68
"7783","WI-643466",2021,155,76,8.59794012820513,79
"7784","WI-643466",2022,169,109,12.3724794915254,60
"7785","WI-643466",2023,151,95,10.0410343636364,56
"7786","WI-653121",1979,157,99,11.8174952631579,58
"7787","WI-653121",1980,152,84,10.2723188059701,68
"7788","WI-653121",1981,156,82,9.30335273972603,74
"7789","WI-653121",1982,133,101,11.1176106451613,32
"7790","WI-653121",1983,161,110,10.8707518,51
"7791","WI-653121",1984,156,92,9.74060095238095,64
"7792","WI-653121",1985,175,81,13.1694209677419,94
"7793","WI-653121",1986,169,83,12.7355427058824,86
"7794","WI-653121",1987,148,92,12.206278,56
"7795","WI-653121",1988,150,80,9.70924173913044,70
"7796","WI-653121",1989,153,81,10.4501801408451,72
"7797","WI-653121",1990,162,85,10.7824503947368,77
"7798","WI-653121",1991,132,74,8.96133631578947,58
"7799","WI-653121",1992,165,84,10.533390875,81
"7800","WI-653121",1993,162,80,9.98785740740741,82
"7801","WI-653121",1994,163,76,10.1294570930233,87
"7802","WI-653121",1995,166,68,9.3963312371134,98
"7803","WI-653121",1996,166,98,10.8028947761194,68
"7804","WI-653121",1997,169,101,11.2600752238806,68
"7805","WI-653121",1998,135,80,10.6308257407407,55
"7806","WI-653121",1999,155,75,10.9054858227848,80
"7807","WI-653121",2000,127,51,7.7821004,76
"7808","WI-653121",2001,161,87,12.2461049315068,74
"7809","WI-653121",2002,150,86,9.30420666666667,64
"7810","WI-653121",2003,173,98,13.1500390540541,75
"7811","WI-653121",2004,158,76,11.5954662962963,82
"7812","WI-653121",2005,155,79,10.8113485333333,76
"7813","WI-653121",2006,146,82,10.53913,64
"7814","WI-653121",2007,149,99,13.2785283673469,50
"7815","WI-653121",2008,155,82,9.99438333333333,73
"7816","WI-653121",2009,168,71,10.3054691666667,97
"7817","WI-653121",2010,143,65,9.80491753246753,78
"7818","WI-653121",2011,152,88,10.8735019047619,64
"7819","WI-653121",2012,80,59,7.991548,21
"7820","WI-653121",2013,163,84,11.1226191025641,79
"7821","WI-653121",2014,149,86,10.849695483871,63
"7822","WI-653121",2015,158,85,12.1281905555556,73
"7823","WI-653121",2016,145,64,8.878695375,81
"7824","WI-653121",2017,160,77,11.8525892682927,83
"7825","WI-653121",2018,145,107,12.9486221621622,38
"7826","WI-653121",2019,175,69,10.9902608571429,106
"7827","WI-653121",2020,145,64,7.28161375,81
"7828","WI-653121",2021,140,65,9.06738135135135,75
"7829","WI-653121",2022,131,72,7.26577275862069,59
"7830","WI-653121",2023,150,76,9.90970767123288,74
"7831","WI-653123",1979,157,99,11.8174952631579,58
"7832","WI-653123",1980,152,84,10.2723188059701,68
"7833","WI-653123",1981,156,82,9.30335273972603,74
"7834","WI-653123",1982,133,101,11.1176106451613,32
"7835","WI-653123",1983,161,110,10.8707518,51
"7836","WI-653123",1984,156,92,9.74060095238095,64
"7837","WI-653123",1985,175,81,13.1694209677419,94
"7838","WI-653123",1986,169,83,12.7355427058824,86
"7839","WI-653123",1987,148,92,12.206278,56
"7840","WI-653123",1988,150,80,9.70924173913044,70
"7841","WI-653123",1989,153,81,10.4501801408451,72
"7842","WI-653123",1990,162,85,10.7824503947368,77
"7843","WI-653123",1991,132,74,8.96133631578947,58
"7844","WI-653123",1992,165,84,10.533390875,81
"7845","WI-653123",1993,162,80,9.98785740740741,82
"7846","WI-653123",1994,163,76,10.1294570930233,87
"7847","WI-653123",1995,166,68,9.3963312371134,98
"7848","WI-653123",1996,166,98,10.8028947761194,68
"7849","WI-653123",1997,169,101,11.2600752238806,68
"7850","WI-653123",1998,135,80,10.6308257407407,55
"7851","WI-653123",1999,155,75,10.9054858227848,80
"7852","WI-653123",2000,127,51,7.7821004,76
"7853","WI-653123",2001,161,87,12.2461049315068,74
"7854","WI-653123",2002,150,86,9.30420666666667,64
"7855","WI-653123",2003,173,98,13.1500390540541,75
"7856","WI-653123",2004,158,76,11.5954662962963,82
"7857","WI-653123",2005,155,79,10.8113485333333,76
"7858","WI-653123",2006,146,82,10.53913,64
"7859","WI-653123",2007,149,99,13.2785283673469,50
"7860","WI-653123",2008,155,82,9.99438333333333,73
"7861","WI-653123",2009,168,71,10.3054691666667,97
"7862","WI-653123",2010,143,65,9.80491753246753,78
"7863","WI-653123",2011,152,88,10.8735019047619,64
"7864","WI-653123",2012,80,59,7.991548,21
"7865","WI-653123",2013,163,84,11.1226191025641,79
"7866","WI-653123",2014,149,86,10.849695483871,63
"7867","WI-653123",2015,158,85,12.1281905555556,73
"7868","WI-653123",2016,145,64,8.878695375,81
"7869","WI-653123",2017,160,77,11.8525892682927,83
"7870","WI-653123",2018,145,107,12.9486221621622,38
"7871","WI-653123",2019,175,69,10.9902608571429,106
"7872","WI-653123",2020,145,64,7.28161375,81
"7873","WI-653123",2021,140,65,9.06738135135135,75
"7874","WI-653123",2022,131,72,7.26577275862069,59
"7875","WI-653123",2023,150,76,9.90970767123288,74
"7876","WI-653124",1979,157,99,11.8174952631579,58
"7877","WI-653124",1980,152,84,10.2723188059701,68
"7878","WI-653124",1981,156,82,9.30335273972603,74
"7879","WI-653124",1982,133,101,11.1176106451613,32
"7880","WI-653124",1983,161,110,10.8707518,51
"7881","WI-653124",1984,156,92,9.74060095238095,64
"7882","WI-653124",1985,175,81,13.1694209677419,94
"7883","WI-653124",1986,169,83,12.7355427058824,86
"7884","WI-653124",1987,148,92,12.206278,56
"7885","WI-653124",1988,150,80,9.70924173913044,70
"7886","WI-653124",1989,153,81,10.4501801408451,72
"7887","WI-653124",1990,162,85,10.7824503947368,77
"7888","WI-653124",1991,132,74,8.96133631578947,58
"7889","WI-653124",1992,165,84,10.533390875,81
"7890","WI-653124",1993,162,80,9.98785740740741,82
"7891","WI-653124",1994,163,76,10.1294570930233,87
"7892","WI-653124",1995,166,68,9.3963312371134,98
"7893","WI-653124",1996,166,98,10.8028947761194,68
"7894","WI-653124",1997,169,101,11.2600752238806,68
"7895","WI-653124",1998,135,80,10.6308257407407,55
"7896","WI-653124",1999,155,75,10.9054858227848,80
"7897","WI-653124",2000,127,51,7.7821004,76
"7898","WI-653124",2001,161,87,12.2461049315068,74
"7899","WI-653124",2002,150,86,9.30420666666667,64
"7900","WI-653124",2003,173,98,13.1500390540541,75
"7901","WI-653124",2004,158,76,11.5954662962963,82
"7902","WI-653124",2005,155,79,10.8113485333333,76
"7903","WI-653124",2006,146,82,10.53913,64
"7904","WI-653124",2007,149,99,13.2785283673469,50
"7905","WI-653124",2008,155,82,9.99438333333333,73
"7906","WI-653124",2009,168,71,10.3054691666667,97
"7907","WI-653124",2010,143,65,9.80491753246753,78
"7908","WI-653124",2011,152,88,10.8735019047619,64
"7909","WI-653124",2012,80,59,7.991548,21
"7910","WI-653124",2013,163,84,11.1226191025641,79
"7911","WI-653124",2014,149,86,10.849695483871,63
"7912","WI-653124",2015,158,85,12.1281905555556,73
"7913","WI-653124",2016,145,64,8.878695375,81
"7914","WI-653124",2017,160,77,11.8525892682927,83
"7915","WI-653124",2018,145,107,12.9486221621622,38
"7916","WI-653124",2019,175,69,10.9902608571429,106
"7917","WI-653124",2020,145,64,7.28161375,81
"7918","WI-653124",2021,140,65,9.06738135135135,75
"7919","WI-653124",2022,131,72,7.26577275862069,59
"7920","WI-653124",2023,150,76,9.90970767123288,74
"7921","WI-653125",1979,157,99,11.8174952631579,58
"7922","WI-653125",1980,152,84,10.2723188059701,68
"7923","WI-653125",1981,156,82,9.30335273972603,74
"7924","WI-653125",1982,133,101,11.1176106451613,32
"7925","WI-653125",1983,161,110,10.8707518,51
"7926","WI-653125",1984,156,92,9.74060095238095,64
"7927","WI-653125",1985,175,81,13.1694209677419,94
"7928","WI-653125",1986,169,83,12.7355427058824,86
"7929","WI-653125",1987,148,92,12.206278,56
"7930","WI-653125",1988,150,80,9.70924173913044,70
"7931","WI-653125",1989,153,81,10.4501801408451,72
"7932","WI-653125",1990,162,85,10.7824503947368,77
"7933","WI-653125",1991,132,74,8.96133631578947,58
"7934","WI-653125",1992,165,84,10.533390875,81
"7935","WI-653125",1993,162,80,9.98785740740741,82
"7936","WI-653125",1994,163,76,10.1294570930233,87
"7937","WI-653125",1995,166,68,9.3963312371134,98
"7938","WI-653125",1996,166,98,10.8028947761194,68
"7939","WI-653125",1997,169,101,11.2600752238806,68
"7940","WI-653125",1998,135,80,10.6308257407407,55
"7941","WI-653125",1999,155,75,10.9054858227848,80
"7942","WI-653125",2000,127,51,7.7821004,76
"7943","WI-653125",2001,161,87,12.2461049315068,74
"7944","WI-653125",2002,150,86,9.30420666666667,64
"7945","WI-653125",2003,173,98,13.1500390540541,75
"7946","WI-653125",2004,158,76,11.5954662962963,82
"7947","WI-653125",2005,155,79,10.8113485333333,76
"7948","WI-653125",2006,146,82,10.53913,64
"7949","WI-653125",2007,149,99,13.2785283673469,50
"7950","WI-653125",2008,155,82,9.99438333333333,73
"7951","WI-653125",2009,168,71,10.3054691666667,97
"7952","WI-653125",2010,143,65,9.80491753246753,78
"7953","WI-653125",2011,152,88,10.8735019047619,64
"7954","WI-653125",2012,80,59,7.991548,21
"7955","WI-653125",2013,163,84,11.1226191025641,79
"7956","WI-653125",2014,149,86,10.849695483871,63
"7957","WI-653125",2015,158,85,12.1281905555556,73
"7958","WI-653125",2016,145,64,8.878695375,81
"7959","WI-653125",2017,160,77,11.8525892682927,83
"7960","WI-653125",2018,145,107,12.9486221621622,38
"7961","WI-653125",2019,175,69,10.9902608571429,106
"7962","WI-653125",2020,145,64,7.28161375,81
"7963","WI-653125",2021,140,65,9.06738135135135,75
"7964","WI-653125",2022,131,72,7.26577275862069,59
"7965","WI-653125",2023,150,76,9.90970767123288,74
"7966","WI-653126",1979,156,98,11.9686735087719,58
"7967","WI-653126",1980,148,76,9.07110985915493,72
"7968","WI-653126",1981,155,79,11.0604754666667,76
"7969","WI-653126",1982,133,101,11.1246674193548,32
"7970","WI-653126",1983,161,109,10.9330664705882,52
"7971","WI-653126",1984,156,92,9.81190587301587,64
"7972","WI-653126",1985,174,82,13.3496383516484,92
"7973","WI-653126",1986,149,83,11.0563764615385,66
"7974","WI-653126",1987,148,91,12.3005898214286,57
"7975","WI-653126",1988,150,79,9.80653214285714,71
"7976","WI-653126",1989,152,80,10.3244178873239,72
"7977","WI-653126",1990,162,81,10.29131775,81
"7978","WI-653126",1991,132,74,9.04850719298246,58
"7979","WI-653126",1992,164,84,10.5935082278481,80
"7980","WI-653126",1993,162,81,10.15096575,81
"7981","WI-653126",1994,163,70,9.73746673913043,93
"7982","WI-653126",1995,155,68,8.48671848837209,87
"7983","WI-653126",1996,166,98,10.966957761194,68
"7984","WI-653126",1997,169,101,11.4823240298507,68
"7985","WI-653126",1998,135,80,10.7766592592593,55
"7986","WI-653126",1999,154,75,10.9437970512821,79
"7987","WI-653126",2000,127,51,7.97407946666667,76
"7988","WI-653126",2001,161,87,12.5344180821918,74
"7989","WI-653126",2002,150,86,9.55916761904762,64
"7990","WI-653126",2003,167,97,12.8074910144928,70
"7991","WI-653126",2004,158,75,11.6072537804878,83
"7992","WI-653126",2005,154,80,10.9993404109589,74
"7993","WI-653126",2006,146,82,10.5103604761905,64
"7994","WI-653126",2007,149,100,13.73542375,49
"7995","WI-653126",2008,155,74,9.1246565,81
"7996","WI-653126",2009,168,72,10.5456266315789,96
"7997","WI-653126",2010,142,65,9.82405236842105,77
"7998","WI-653126",2011,152,88,10.9362495238095,64
"7999","WI-653126",2012,147,62,12.0036755952381,85
"8000","WI-653126",2013,163,85,11.1689780519481,78
"8001","WI-653126",2014,148,86,10.7113967213115,62
"8002","WI-653126",2015,158,86,12.4397476056338,72
"8003","WI-653126",2016,145,64,8.994906625,81
"8004","WI-653126",2017,160,76,11.8231504819277,84
"8005","WI-653126",2018,144,107,12.9669952777778,37
"8006","WI-653126",2019,175,69,11.0976275238095,106
"8007","WI-653126",2020,145,65,7.43316379746835,80
"8008","WI-653126",2021,140,66,9.1553498630137,74
"8009","WI-653126",2022,130,88,7.71996463414634,42
"8010","WI-653126",2023,150,76,9.9182697260274,74
"8011","WI-653217",1979,157,99,11.8174952631579,58
"8012","WI-653217",1980,152,84,10.2723188059701,68
"8013","WI-653217",1981,156,82,9.30335273972603,74
"8014","WI-653217",1982,133,101,11.1176106451613,32
"8015","WI-653217",1983,161,110,10.8707518,51
"8016","WI-653217",1984,156,92,9.74060095238095,64
"8017","WI-653217",1985,175,81,13.1694209677419,94
"8018","WI-653217",1986,169,83,12.7355427058824,86
"8019","WI-653217",1987,148,92,12.206278,56
"8020","WI-653217",1988,150,80,9.70924173913044,70
"8021","WI-653217",1989,153,81,10.4501801408451,72
"8022","WI-653217",1990,162,85,10.7824503947368,77
"8023","WI-653217",1991,132,74,8.96133631578947,58
"8024","WI-653217",1992,165,84,10.533390875,81
"8025","WI-653217",1993,162,80,9.98785740740741,82
"8026","WI-653217",1994,163,76,10.1294570930233,87
"8027","WI-653217",1995,166,68,9.3963312371134,98
"8028","WI-653217",1996,166,98,10.8028947761194,68
"8029","WI-653217",1997,169,101,11.2600752238806,68
"8030","WI-653217",1998,135,80,10.6308257407407,55
"8031","WI-653217",1999,155,75,10.9054858227848,80
"8032","WI-653217",2000,127,51,7.7821004,76
"8033","WI-653217",2001,161,87,12.2461049315068,74
"8034","WI-653217",2002,150,86,9.30420666666667,64
"8035","WI-653217",2003,173,98,13.1500390540541,75
"8036","WI-653217",2004,158,76,11.5954662962963,82
"8037","WI-653217",2005,155,79,10.8113485333333,76
"8038","WI-653217",2006,146,82,10.53913,64
"8039","WI-653217",2007,149,99,13.2785283673469,50
"8040","WI-653217",2008,155,82,9.99438333333333,73
"8041","WI-653217",2009,168,71,10.3054691666667,97
"8042","WI-653217",2010,143,65,9.80491753246753,78
"8043","WI-653217",2011,152,88,10.8735019047619,64
"8044","WI-653217",2012,80,59,7.991548,21
"8045","WI-653217",2013,163,84,11.1226191025641,79
"8046","WI-653217",2014,149,86,10.849695483871,63
"8047","WI-653217",2015,158,85,12.1281905555556,73
"8048","WI-653217",2016,145,64,8.878695375,81
"8049","WI-653217",2017,160,77,11.8525892682927,83
"8050","WI-653217",2018,145,107,12.9486221621622,38
"8051","WI-653217",2019,175,69,10.9902608571429,106
"8052","WI-653217",2020,145,64,7.28161375,81
"8053","WI-653217",2021,140,65,9.06738135135135,75
"8054","WI-653217",2022,131,72,7.26577275862069,59
"8055","WI-653217",2023,150,76,9.90970767123288,74
"8056","WI-663045",1979,190,100,12.1174782022472,90
"8057","WI-663045",1980,146,88,9.25487421052632,58
"8058","WI-663045",1981,181,79,11.5733696039604,102
"8059","WI-663045",1982,184,101,12.8438742682927,83
"8060","WI-663045",1983,172,108,11.3361257142857,64
"8061","WI-663045",1984,172,90,10.7351412345679,82
"8062","WI-663045",1985,185,92,13.3659731521739,93
"8063","WI-663045",1986,170,84,11.6272621176471,86
"8064","WI-663045",1987,149,92,12.2138182142857,57
"8065","WI-663045",1988,150,84,9.39989569230769,66
"8066","WI-663045",1989,171,101,11.7567652173913,70
"8067","WI-663045",1990,166,86,10.2215308860759,80
"8068","WI-663045",1991,133,90,8.48121785714286,43
"8069","WI-663045",1992,166,90,10.296874,76
"8070","WI-663045",1993,186,83,10.4996391176471,103
"8071","WI-663045",1994,165,88,9.96465078947368,77
"8072","WI-663045",1995,166,98,10.0280944776119,68
"8073","WI-663045",1996,165,103,9.58257360655738,62
"8074","WI-663045",1997,172,101,10.6306668571429,71
"8075","WI-663045",1998,166,81,11.7889313095238,85
"8076","WI-663045",1999,157,81,10.6690518666667,76
"8077","WI-663045",2000,185,77,11.4374248598131,108
"8078","WI-663045",2001,162,89,10.6466491666667,73
"8079","WI-663045",2002,160,96,9.50611603174603,64
"8080","WI-663045",2003,166,98,11.8084431343284,68
"8081","WI-663045",2004,193,82,11.6518012727273,111
"8082","WI-663045",2005,156,85,9.792482,71
"8083","WI-663045",2006,146,85,9.06140733333333,61
"8084","WI-663045",2007,152,101,13.373379,51
"8085","WI-663045",2008,187,91,11.6301202105263,96
"8086","WI-663045",2009,168,95,10.9656591666667,73
"8087","WI-663045",2010,142,66,8.6951012,76
"8088","WI-663045",2011,156,89,9.47147227272727,67
"8089","WI-663045",2012,159,68,10.7679065555556,91
"8090","WI-663045",2013,172,95,10.4637265789474,77
"8091","WI-663045",2014,149,95,8.37558924528302,54
"8092","WI-663045",2015,191,86,13.0583809615385,105
"8093","WI-663045",2016,164,98,12.4358103076923,66
"8094","WI-663045",2017,159,77,9.77350888888889,82
"8095","WI-663045",2018,144,109,11.9959911764706,35
"8096","WI-663045",2019,177,87,10.6412805617978,90
"8097","WI-663045",2020,171,107,12.4006352380952,64
"8098","WI-663045",2021,141,68,7.17171222222222,73
"8099","WI-663045",2022,167,107,12.7977605084746,60
"8100","WI-663045",2023,151,94,10.5752957142857,57
"8101","WI-663053",1979,190,100,12.1174782022472,90
"8102","WI-663053",1980,146,88,9.25487421052632,58
"8103","WI-663053",1981,181,79,11.5733696039604,102
"8104","WI-663053",1982,184,101,12.8438742682927,83
"8105","WI-663053",1983,172,108,11.3361257142857,64
"8106","WI-663053",1984,172,90,10.7351412345679,82
"8107","WI-663053",1985,185,92,13.3659731521739,93
"8108","WI-663053",1986,170,84,11.6272621176471,86
"8109","WI-663053",1987,149,92,12.2138182142857,57
"8110","WI-663053",1988,150,84,9.39989569230769,66
"8111","WI-663053",1989,171,101,11.7567652173913,70
"8112","WI-663053",1990,166,86,10.2215308860759,80
"8113","WI-663053",1991,133,90,8.48121785714286,43
"8114","WI-663053",1992,166,90,10.296874,76
"8115","WI-663053",1993,186,83,10.4996391176471,103
"8116","WI-663053",1994,165,88,9.96465078947368,77
"8117","WI-663053",1995,166,98,10.0280944776119,68
"8118","WI-663053",1996,165,103,9.58257360655738,62
"8119","WI-663053",1997,172,101,10.6306668571429,71
"8120","WI-663053",1998,166,81,11.7889313095238,85
"8121","WI-663053",1999,157,81,10.6690518666667,76
"8122","WI-663053",2000,185,77,11.4374248598131,108
"8123","WI-663053",2001,162,89,10.6466491666667,73
"8124","WI-663053",2002,160,96,9.50611603174603,64
"8125","WI-663053",2003,166,98,11.8084431343284,68
"8126","WI-663053",2004,193,82,11.6518012727273,111
"8127","WI-663053",2005,156,85,9.792482,71
"8128","WI-663053",2006,146,85,9.06140733333333,61
"8129","WI-663053",2007,152,101,13.373379,51
"8130","WI-663053",2008,187,91,11.6301202105263,96
"8131","WI-663053",2009,168,95,10.9656591666667,73
"8132","WI-663053",2010,142,66,8.6951012,76
"8133","WI-663053",2011,156,89,9.47147227272727,67
"8134","WI-663053",2012,159,68,10.7679065555556,91
"8135","WI-663053",2013,172,95,10.4637265789474,77
"8136","WI-663053",2014,149,95,8.37558924528302,54
"8137","WI-663053",2015,191,86,13.0583809615385,105
"8138","WI-663053",2016,164,98,12.4358103076923,66
"8139","WI-663053",2017,159,77,9.77350888888889,82
"8140","WI-663053",2018,144,109,11.9959911764706,35
"8141","WI-663053",2019,177,87,10.6412805617978,90
"8142","WI-663053",2020,171,107,12.4006352380952,64
"8143","WI-663053",2021,141,68,7.17171222222222,73
"8144","WI-663053",2022,167,107,12.7977605084746,60
"8145","WI-663053",2023,151,94,10.5752957142857,57
"8146","WI-663088",1979,190,100,12.1174782022472,90
"8147","WI-663088",1980,146,88,9.25487421052632,58
"8148","WI-663088",1981,181,79,11.5733696039604,102
"8149","WI-663088",1982,184,101,12.8438742682927,83
"8150","WI-663088",1983,172,108,11.3361257142857,64
"8151","WI-663088",1984,172,90,10.7351412345679,82
"8152","WI-663088",1985,185,92,13.3659731521739,93
"8153","WI-663088",1986,170,84,11.6272621176471,86
"8154","WI-663088",1987,149,92,12.2138182142857,57
"8155","WI-663088",1988,150,84,9.39989569230769,66
"8156","WI-663088",1989,171,101,11.7567652173913,70
"8157","WI-663088",1990,166,86,10.2215308860759,80
"8158","WI-663088",1991,133,90,8.48121785714286,43
"8159","WI-663088",1992,166,90,10.296874,76
"8160","WI-663088",1993,186,83,10.4996391176471,103
"8161","WI-663088",1994,165,88,9.96465078947368,77
"8162","WI-663088",1995,166,98,10.0280944776119,68
"8163","WI-663088",1996,165,103,9.58257360655738,62
"8164","WI-663088",1997,172,101,10.6306668571429,71
"8165","WI-663088",1998,166,81,11.7889313095238,85
"8166","WI-663088",1999,157,81,10.6690518666667,76
"8167","WI-663088",2000,185,77,11.4374248598131,108
"8168","WI-663088",2001,162,89,10.6466491666667,73
"8169","WI-663088",2002,160,96,9.50611603174603,64
"8170","WI-663088",2003,166,98,11.8084431343284,68
"8171","WI-663088",2004,193,82,11.6518012727273,111
"8172","WI-663088",2005,156,85,9.792482,71
"8173","WI-663088",2006,146,85,9.06140733333333,61
"8174","WI-663088",2007,152,101,13.373379,51
"8175","WI-663088",2008,187,91,11.6301202105263,96
"8176","WI-663088",2009,168,95,10.9656591666667,73
"8177","WI-663088",2010,142,66,8.6951012,76
"8178","WI-663088",2011,156,89,9.47147227272727,67
"8179","WI-663088",2012,159,68,10.7679065555556,91
"8180","WI-663088",2013,172,95,10.4637265789474,77
"8181","WI-663088",2014,149,95,8.37558924528302,54
"8182","WI-663088",2015,191,86,13.0583809615385,105
"8183","WI-663088",2016,164,98,12.4358103076923,66
"8184","WI-663088",2017,159,77,9.77350888888889,82
"8185","WI-663088",2018,144,109,11.9959911764706,35
"8186","WI-663088",2019,177,87,10.6412805617978,90
"8187","WI-663088",2020,171,107,12.4006352380952,64
"8188","WI-663088",2021,141,68,7.17171222222222,73
"8189","WI-663088",2022,167,107,12.7977605084746,60
"8190","WI-663088",2023,151,94,10.5752957142857,57
"8191","WI-663091",1979,190,100,12.1174782022472,90
"8192","WI-663091",1980,146,88,9.25487421052632,58
"8193","WI-663091",1981,181,79,11.5733696039604,102
"8194","WI-663091",1982,184,101,12.8438742682927,83
"8195","WI-663091",1983,172,108,11.3361257142857,64
"8196","WI-663091",1984,172,90,10.7351412345679,82
"8197","WI-663091",1985,185,92,13.3659731521739,93
"8198","WI-663091",1986,170,84,11.6272621176471,86
"8199","WI-663091",1987,149,92,12.2138182142857,57
"8200","WI-663091",1988,150,84,9.39989569230769,66
"8201","WI-663091",1989,171,101,11.7567652173913,70
"8202","WI-663091",1990,166,86,10.2215308860759,80
"8203","WI-663091",1991,133,90,8.48121785714286,43
"8204","WI-663091",1992,166,90,10.296874,76
"8205","WI-663091",1993,186,83,10.4996391176471,103
"8206","WI-663091",1994,165,88,9.96465078947368,77
"8207","WI-663091",1995,166,98,10.0280944776119,68
"8208","WI-663091",1996,165,103,9.58257360655738,62
"8209","WI-663091",1997,172,101,10.6306668571429,71
"8210","WI-663091",1998,166,81,11.7889313095238,85
"8211","WI-663091",1999,157,81,10.6690518666667,76
"8212","WI-663091",2000,185,77,11.4374248598131,108
"8213","WI-663091",2001,162,89,10.6466491666667,73
"8214","WI-663091",2002,160,96,9.50611603174603,64
"8215","WI-663091",2003,166,98,11.8084431343284,68
"8216","WI-663091",2004,193,82,11.6518012727273,111
"8217","WI-663091",2005,156,85,9.792482,71
"8218","WI-663091",2006,146,85,9.06140733333333,61
"8219","WI-663091",2007,152,101,13.373379,51
"8220","WI-663091",2008,187,91,11.6301202105263,96
"8221","WI-663091",2009,168,95,10.9656591666667,73
"8222","WI-663091",2010,142,66,8.6951012,76
"8223","WI-663091",2011,156,89,9.47147227272727,67
"8224","WI-663091",2012,159,68,10.7679065555556,91
"8225","WI-663091",2013,172,95,10.4637265789474,77
"8226","WI-663091",2014,149,95,8.37558924528302,54
"8227","WI-663091",2015,191,86,13.0583809615385,105
"8228","WI-663091",2016,164,98,12.4358103076923,66
"8229","WI-663091",2017,159,77,9.77350888888889,82
"8230","WI-663091",2018,144,109,11.9959911764706,35
"8231","WI-663091",2019,177,87,10.6412805617978,90
"8232","WI-663091",2020,171,107,12.4006352380952,64
"8233","WI-663091",2021,141,68,7.17171222222222,73
"8234","WI-663091",2022,167,107,12.7977605084746,60
"8235","WI-663091",2023,151,94,10.5752957142857,57
"8236","WI-663099",1979,190,102,11.8411526436782,88
"8237","WI-663099",1980,147,92,10.0647848148148,55
"8238","WI-663099",1981,182,79,11.325487745098,103
"8239","WI-663099",1982,184,101,12.5053645121951,83
"8240","WI-663099",1983,172,108,11.1299007936508,64
"8241","WI-663099",1984,193,92,12.2597658,101
"8242","WI-663099",1985,185,91,12.713,94
"8243","WI-663099",1986,170,85,11.0651883333333,85
"8244","WI-663099",1987,149,92,11.8781596428571,57
"8245","WI-663099",1988,150,90,9.70795525423729,60
"8246","WI-663099",1989,171,102,11.2322327941176,69
"8247","WI-663099",1990,177,99,12.2718831168831,78
"8248","WI-663099",1991,133,90,8.15365095238095,43
"8249","WI-663099",1992,NA,91,NA,NA
"8250","WI-663099",1993,206,93,12.4009567857143,113
"8251","WI-663099",1994,166,93,10.5780859722222,73
"8252","WI-663099",1995,166,98,9.61414925373134,68
"8253","WI-663099",1996,165,103,9.26866360655738,62
"8254","WI-663099",1997,173,102,10.64932,71
"8255","WI-663099",1998,167,81,11.4190661176471,86
"8256","WI-663099",1999,157,84,10.2137691666667,73
"8257","WI-663099",2000,189,77,11.3499289189189,112
"8258","WI-663099",2001,162,89,10.44699625,73
"8259","WI-663099",2002,160,96,9.15331317460318,64
"8260","WI-663099",2003,167,98,11.5857289705882,69
"8261","WI-663099",2004,193,83,11.1080467889908,110
"8262","WI-663099",2005,159,85,10.4409815068493,74
"8263","WI-663099",2006,146,85,9.0641425,61
"8264","WI-663099",2007,162,101,13.8424615,61
"8265","WI-663099",2008,190,91,11.4089417346939,99
"8266","WI-663099",2009,168,96,10.6942667605634,72
"8267","WI-663099",2010,142,67,8.41594162162162,75
"8268","WI-663099",2011,179,89,11.0451587640449,90
"8269","WI-663099",2012,160,69,10.3704245555556,91
"8270","WI-663099",2013,173,107,11.8040952307692,66
"8271","WI-663099",2014,170,106,11.8650603174603,64
"8272","WI-663099",2015,178,86,11.9143404395604,92
"8273","WI-663099",2016,164,100,12.3445742857143,64
"8274","WI-663099",2017,160,77,9.62802768292683,83
"8275","WI-663099",2018,144,108,11.6913654285714,36
"8276","WI-663099",2019,177,82,9.77970010638298,95
"8277","WI-663099",2020,171,104,11.5499392424242,67
"8278","WI-663099",2021,142,74,7.49779104477612,68
"8279","WI-663099",2022,168,107,12.4083853333333,61
"8280","WI-663099",2023,151,97,10.4417266037736,54
"8281","WI-663101",1979,190,102,11.8411526436782,88
"8282","WI-663101",1980,147,92,10.0647848148148,55
"8283","WI-663101",1981,182,79,11.325487745098,103
"8284","WI-663101",1982,184,101,12.5053645121951,83
"8285","WI-663101",1983,172,108,11.1299007936508,64
"8286","WI-663101",1984,193,92,12.2597658,101
"8287","WI-663101",1985,185,91,12.713,94
"8288","WI-663101",1986,170,85,11.0651883333333,85
"8289","WI-663101",1987,149,92,11.8781596428571,57
"8290","WI-663101",1988,150,90,9.70795525423729,60
"8291","WI-663101",1989,171,102,11.2322327941176,69
"8292","WI-663101",1990,177,99,12.2718831168831,78
"8293","WI-663101",1991,133,90,8.15365095238095,43
"8294","WI-663101",1992,NA,91,NA,NA
"8295","WI-663101",1993,206,93,12.4009567857143,113
"8296","WI-663101",1994,166,93,10.5780859722222,73
"8297","WI-663101",1995,166,98,9.61414925373134,68
"8298","WI-663101",1996,165,103,9.26866360655738,62
"8299","WI-663101",1997,173,102,10.64932,71
"8300","WI-663101",1998,167,81,11.4190661176471,86
"8301","WI-663101",1999,157,84,10.2137691666667,73
"8302","WI-663101",2000,189,77,11.3499289189189,112
"8303","WI-663101",2001,162,89,10.44699625,73
"8304","WI-663101",2002,160,96,9.15331317460318,64
"8305","WI-663101",2003,167,98,11.5857289705882,69
"8306","WI-663101",2004,193,83,11.1080467889908,110
"8307","WI-663101",2005,159,85,10.4409815068493,74
"8308","WI-663101",2006,146,85,9.0641425,61
"8309","WI-663101",2007,162,101,13.8424615,61
"8310","WI-663101",2008,190,91,11.4089417346939,99
"8311","WI-663101",2009,168,96,10.6942667605634,72
"8312","WI-663101",2010,142,67,8.41594162162162,75
"8313","WI-663101",2011,179,89,11.0451587640449,90
"8314","WI-663101",2012,160,69,10.3704245555556,91
"8315","WI-663101",2013,173,107,11.8040952307692,66
"8316","WI-663101",2014,170,106,11.8650603174603,64
"8317","WI-663101",2015,178,86,11.9143404395604,92
"8318","WI-663101",2016,164,100,12.3445742857143,64
"8319","WI-663101",2017,160,77,9.62802768292683,83
"8320","WI-663101",2018,144,108,11.6913654285714,36
"8321","WI-663101",2019,177,82,9.77970010638298,95
"8322","WI-663101",2020,171,104,11.5499392424242,67
"8323","WI-663101",2021,142,74,7.49779104477612,68
"8324","WI-663101",2022,168,107,12.4083853333333,61
"8325","WI-663101",2023,151,97,10.4417266037736,54
"8326","WI-663105",1979,190,100,12.1174782022472,90
"8327","WI-663105",1980,146,88,9.25487421052632,58
"8328","WI-663105",1981,181,79,11.5733696039604,102
"8329","WI-663105",1982,184,101,12.8438742682927,83
"8330","WI-663105",1983,172,108,11.3361257142857,64
"8331","WI-663105",1984,172,90,10.7351412345679,82
"8332","WI-663105",1985,185,92,13.3659731521739,93
"8333","WI-663105",1986,170,84,11.6272621176471,86
"8334","WI-663105",1987,149,92,12.2138182142857,57
"8335","WI-663105",1988,150,84,9.39989569230769,66
"8336","WI-663105",1989,171,101,11.7567652173913,70
"8337","WI-663105",1990,166,86,10.2215308860759,80
"8338","WI-663105",1991,133,90,8.48121785714286,43
"8339","WI-663105",1992,166,90,10.296874,76
"8340","WI-663105",1993,186,83,10.4996391176471,103
"8341","WI-663105",1994,165,88,9.96465078947368,77
"8342","WI-663105",1995,166,98,10.0280944776119,68
"8343","WI-663105",1996,165,103,9.58257360655738,62
"8344","WI-663105",1997,172,101,10.6306668571429,71
"8345","WI-663105",1998,166,81,11.7889313095238,85
"8346","WI-663105",1999,157,81,10.6690518666667,76
"8347","WI-663105",2000,185,77,11.4374248598131,108
"8348","WI-663105",2001,162,89,10.6466491666667,73
"8349","WI-663105",2002,160,96,9.50611603174603,64
"8350","WI-663105",2003,166,98,11.8084431343284,68
"8351","WI-663105",2004,193,82,11.6518012727273,111
"8352","WI-663105",2005,156,85,9.792482,71
"8353","WI-663105",2006,146,85,9.06140733333333,61
"8354","WI-663105",2007,152,101,13.373379,51
"8355","WI-663105",2008,187,91,11.6301202105263,96
"8356","WI-663105",2009,168,95,10.9656591666667,73
"8357","WI-663105",2010,142,66,8.6951012,76
"8358","WI-663105",2011,156,89,9.47147227272727,67
"8359","WI-663105",2012,159,68,10.7679065555556,91
"8360","WI-663105",2013,172,95,10.4637265789474,77
"8361","WI-663105",2014,149,95,8.37558924528302,54
"8362","WI-663105",2015,191,86,13.0583809615385,105
"8363","WI-663105",2016,164,98,12.4358103076923,66
"8364","WI-663105",2017,159,77,9.77350888888889,82
"8365","WI-663105",2018,144,109,11.9959911764706,35
"8366","WI-663105",2019,177,87,10.6412805617978,90
"8367","WI-663105",2020,171,107,12.4006352380952,64
"8368","WI-663105",2021,141,68,7.17171222222222,73
"8369","WI-663105",2022,167,107,12.7977605084746,60
"8370","WI-663105",2023,151,94,10.5752957142857,57
"8371","WI-663128",1979,190,100,11.7285212359551,90
"8372","WI-663128",1980,147,88,9.35328724137931,59
"8373","WI-663128",1981,182,79,11.2793023529412,103
"8374","WI-663128",1982,184,100,12.2642357831325,84
"8375","WI-663128",1983,172,108,11.1059674603175,64
"8376","WI-663128",1984,193,91,12.1749521782178,102
"8377","WI-663128",1985,185,96,13.3622438636364,89
"8378","WI-663128",1986,186,84,12.3808808910891,102
"8379","WI-663128",1987,150,92,11.9982233333333,58
"8380","WI-663128",1988,150,84,9.19388569230769,66
"8381","WI-663128",1989,171,101,11.303754057971,70
"8382","WI-663128",1990,177,99,12.2810157142857,78
"8383","WI-663128",1991,133,90,8.27623261904762,43
"8384","WI-663128",1992,NA,90,NA,NA
"8385","WI-663128",1993,207,93,12.4778109734513,114
"8386","WI-663128",1994,166,90,10.0845464,76
"8387","WI-663128",1995,166,98,9.67256791044776,68
"8388","WI-663128",1996,179,104,10.8310737837838,75
"8389","WI-663128",1997,173,102,10.6075787142857,71
"8390","WI-663128",1998,167,81,11.6105182352941,86
"8391","WI-663128",1999,157,84,10.5165030555556,73
"8392","WI-663128",2000,189,77,11.3388081981982,112
"8393","WI-663128",2001,162,89,10.4512281944444,73
"8394","WI-663128",2002,160,96,9.08213333333333,64
"8395","WI-663128",2003,167,98,11.6874067647059,69
"8396","WI-663128",2004,194,83,11.3211538181818,111
"8397","WI-663128",2005,158,85,10.2353897222222,73
"8398","WI-663128",2006,146,86,9.08764372881356,60
"8399","WI-663128",2007,163,101,13.8800975409836,62
"8400","WI-663128",2008,190,91,11.5065187755102,99
"8401","WI-663128",2009,168,95,10.5905506944444,73
"8402","WI-663128",2010,142,66,8.47937186666667,76
"8403","WI-663128",2011,179,89,11.2010574157303,90
"8404","WI-663128",2012,160,70,10.393548988764,90
"8405","WI-663128",2013,173,103,11.2975434782609,70
"8406","WI-663128",2014,149,106,9.20181333333333,43
"8407","WI-663128",2015,192,86,12.8366774285714,106
"8408","WI-663128",2016,164,100,12.4461374603175,64
"8409","WI-663128",2017,160,77,9.58629707317073,83
"8410","WI-663128",2018,144,109,11.6690152941176,35
"8411","WI-663128",2019,177,91,10.7051794117647,86
"8412","WI-663128",2020,178,107,12.772979,71
"8413","WI-663128",2021,142,76,7.79521076923077,66
"8414","WI-663128",2022,168,107,12.410859,61
"8415","WI-663128",2023,151,96,10.1909524074074,55
"8416","WI-673120",1979,169,99,12.6095534782609,70
"8417","WI-673120",1980,175,85,11.7864066292135,90
"8418","WI-673120",1981,163,80,10.7676124390244,83
"8419","WI-673120",1982,134,102,10.9687906451613,32
"8420","WI-673120",1983,162,91,8.47311428571428,71
"8421","WI-673120",1984,156,92,9.55930158730159,64
"8422","WI-673120",1985,180,78,12.6667630693069,102
"8423","WI-673120",1986,170,82,12.334397816092,88
"8424","WI-673120",1987,148,92,11.7108232727273,56
"8425","WI-673120",1988,150,81,9.52168485294118,69
"8426","WI-673120",1989,171,81,11.2950207865169,90
"8427","WI-673120",1990,162,85,10.3569780263158,77
"8428","WI-673120",1991,133,73,8.43195694915254,60
"8429","WI-673120",1992,166,84,10.2626345679012,82
"8430","WI-673120",1993,172,80,10.3629510989011,92
"8431","WI-673120",1994,163,76,9.6239161627907,87
"8432","WI-673120",1995,166,68,8.86999381443299,98
"8433","WI-673120",1996,179,98,11.419872,81
"8434","WI-673120",1997,170,101,10.8089580882353,69
"8435","WI-673120",1998,136,81,10.4279340740741,55
"8436","WI-673120",1999,156,75,10.556469625,81
"8437","WI-673120",2000,163,51,9.84232963963964,112
"8438","WI-673120",2001,161,87,11.6729024657534,74
"8439","WI-673120",2002,161,94,11.022595,67
"8440","WI-673120",2003,173,98,12.5956683783784,75
"8441","WI-673120",2004,161,79,11.5656092592593,82
"8442","WI-673120",2005,155,80,10.4538744594595,75
"8443","WI-673120",2006,146,82,10.0826563492063,64
"8444","WI-673120",2007,150,100,13.0559732653061,50
"8445","WI-673120",2008,156,86,10.040421884058,70
"8446","WI-673120",2009,169,73,10.0101229473684,96
"8447","WI-673120",2010,143,65,9.17038077922078,78
"8448","WI-673120",2011,153,88,10.23509921875,65
"8449","WI-673120",2012,166,63,12.436417254902,103
"8450","WI-673120",2013,165,84,10.564949,81
"8451","WI-673120",2014,150,86,9.997,64
"8452","WI-673120",2015,163,86,12.1700976315789,77
"8453","WI-673120",2016,146,64,8.19155037037037,82
"8454","WI-673120",2017,160,77,11.0656219512195,83
"8455","WI-673120",2018,145,108,12.7213708333333,37
"8456","WI-673120",2019,175,70,10.2328908653846,105
"8457","WI-673120",2020,146,65,6.689203875,81
"8458","WI-673120",2021,140,65,8.50762662162162,75
"8459","WI-673120",2022,131,89,7.53506414634146,42
"8460","WI-673120",2023,150,76,9.36989657534247,74
"8461","WI-673123",1979,169,99,12.6095534782609,70
"8462","WI-673123",1980,175,85,11.7864066292135,90
"8463","WI-673123",1981,163,80,10.7676124390244,83
"8464","WI-673123",1982,134,102,10.9687906451613,32
"8465","WI-673123",1983,162,91,8.47311428571428,71
"8466","WI-673123",1984,156,92,9.55930158730159,64
"8467","WI-673123",1985,180,78,12.6667630693069,102
"8468","WI-673123",1986,170,82,12.334397816092,88
"8469","WI-673123",1987,148,92,11.7108232727273,56
"8470","WI-673123",1988,150,81,9.52168485294118,69
"8471","WI-673123",1989,171,81,11.2950207865169,90
"8472","WI-673123",1990,162,85,10.3569780263158,77
"8473","WI-673123",1991,133,73,8.43195694915254,60
"8474","WI-673123",1992,166,84,10.2626345679012,82
"8475","WI-673123",1993,172,80,10.3629510989011,92
"8476","WI-673123",1994,163,76,9.6239161627907,87
"8477","WI-673123",1995,166,68,8.86999381443299,98
"8478","WI-673123",1996,179,98,11.419872,81
"8479","WI-673123",1997,170,101,10.8089580882353,69
"8480","WI-673123",1998,136,81,10.4279340740741,55
"8481","WI-673123",1999,156,75,10.556469625,81
"8482","WI-673123",2000,163,51,9.84232963963964,112
"8483","WI-673123",2001,161,87,11.6729024657534,74
"8484","WI-673123",2002,161,94,11.022595,67
"8485","WI-673123",2003,173,98,12.5956683783784,75
"8486","WI-673123",2004,161,79,11.5656092592593,82
"8487","WI-673123",2005,155,80,10.4538744594595,75
"8488","WI-673123",2006,146,82,10.0826563492063,64
"8489","WI-673123",2007,150,100,13.0559732653061,50
"8490","WI-673123",2008,156,86,10.040421884058,70
"8491","WI-673123",2009,169,73,10.0101229473684,96
"8492","WI-673123",2010,143,65,9.17038077922078,78
"8493","WI-673123",2011,153,88,10.23509921875,65
"8494","WI-673123",2012,166,63,12.436417254902,103
"8495","WI-673123",2013,165,84,10.564949,81
"8496","WI-673123",2014,150,86,9.997,64
"8497","WI-673123",2015,163,86,12.1700976315789,77
"8498","WI-673123",2016,146,64,8.19155037037037,82
"8499","WI-673123",2017,160,77,11.0656219512195,83
"8500","WI-673123",2018,145,108,12.7213708333333,37
"8501","WI-673123",2019,175,70,10.2328908653846,105
"8502","WI-673123",2020,146,65,6.689203875,81
"8503","WI-673123",2021,140,65,8.50762662162162,75
"8504","WI-673123",2022,131,89,7.53506414634146,42
"8505","WI-673123",2023,150,76,9.36989657534247,74
"8506","WI-673202",1979,169,99,12.6095534782609,70
"8507","WI-673202",1980,175,85,11.7864066292135,90
"8508","WI-673202",1981,163,80,10.7676124390244,83
"8509","WI-673202",1982,134,102,10.9687906451613,32
"8510","WI-673202",1983,162,91,8.47311428571428,71
"8511","WI-673202",1984,156,92,9.55930158730159,64
"8512","WI-673202",1985,180,78,12.6667630693069,102
"8513","WI-673202",1986,170,82,12.334397816092,88
"8514","WI-673202",1987,148,92,11.7108232727273,56
"8515","WI-673202",1988,150,81,9.52168485294118,69
"8516","WI-673202",1989,171,81,11.2950207865169,90
"8517","WI-673202",1990,162,85,10.3569780263158,77
"8518","WI-673202",1991,133,73,8.43195694915254,60
"8519","WI-673202",1992,166,84,10.2626345679012,82
"8520","WI-673202",1993,172,80,10.3629510989011,92
"8521","WI-673202",1994,163,76,9.6239161627907,87
"8522","WI-673202",1995,166,68,8.86999381443299,98
"8523","WI-673202",1996,179,98,11.419872,81
"8524","WI-673202",1997,170,101,10.8089580882353,69
"8525","WI-673202",1998,136,81,10.4279340740741,55
"8526","WI-673202",1999,156,75,10.556469625,81
"8527","WI-673202",2000,163,51,9.84232963963964,112
"8528","WI-673202",2001,161,87,11.6729024657534,74
"8529","WI-673202",2002,161,94,11.022595,67
"8530","WI-673202",2003,173,98,12.5956683783784,75
"8531","WI-673202",2004,161,79,11.5656092592593,82
"8532","WI-673202",2005,155,80,10.4538744594595,75
"8533","WI-673202",2006,146,82,10.0826563492063,64
"8534","WI-673202",2007,150,100,13.0559732653061,50
"8535","WI-673202",2008,156,86,10.040421884058,70
"8536","WI-673202",2009,169,73,10.0101229473684,96
"8537","WI-673202",2010,143,65,9.17038077922078,78
"8538","WI-673202",2011,153,88,10.23509921875,65
"8539","WI-673202",2012,166,63,12.436417254902,103
"8540","WI-673202",2013,165,84,10.564949,81
"8541","WI-673202",2014,150,86,9.997,64
"8542","WI-673202",2015,163,86,12.1700976315789,77
"8543","WI-673202",2016,146,64,8.19155037037037,82
"8544","WI-673202",2017,160,77,11.0656219512195,83
"8545","WI-673202",2018,145,108,12.7213708333333,37
"8546","WI-673202",2019,175,70,10.2328908653846,105
"8547","WI-673202",2020,146,65,6.689203875,81
"8548","WI-673202",2021,140,65,8.50762662162162,75
"8549","WI-673202",2022,131,89,7.53506414634146,42
"8550","WI-673202",2023,150,76,9.36989657534247,74
"8551","WI-673206",1979,169,99,12.6095534782609,70
"8552","WI-673206",1980,175,85,11.7864066292135,90
"8553","WI-673206",1981,163,80,10.7676124390244,83
"8554","WI-673206",1982,134,102,10.9687906451613,32
"8555","WI-673206",1983,162,91,8.47311428571428,71
"8556","WI-673206",1984,156,92,9.55930158730159,64
"8557","WI-673206",1985,180,78,12.6667630693069,102
"8558","WI-673206",1986,170,82,12.334397816092,88
"8559","WI-673206",1987,148,92,11.7108232727273,56
"8560","WI-673206",1988,150,81,9.52168485294118,69
"8561","WI-673206",1989,171,81,11.2950207865169,90
"8562","WI-673206",1990,162,85,10.3569780263158,77
"8563","WI-673206",1991,133,73,8.43195694915254,60
"8564","WI-673206",1992,166,84,10.2626345679012,82
"8565","WI-673206",1993,172,80,10.3629510989011,92
"8566","WI-673206",1994,163,76,9.6239161627907,87
"8567","WI-673206",1995,166,68,8.86999381443299,98
"8568","WI-673206",1996,179,98,11.419872,81
"8569","WI-673206",1997,170,101,10.8089580882353,69
"8570","WI-673206",1998,136,81,10.4279340740741,55
"8571","WI-673206",1999,156,75,10.556469625,81
"8572","WI-673206",2000,163,51,9.84232963963964,112
"8573","WI-673206",2001,161,87,11.6729024657534,74
"8574","WI-673206",2002,161,94,11.022595,67
"8575","WI-673206",2003,173,98,12.5956683783784,75
"8576","WI-673206",2004,161,79,11.5656092592593,82
"8577","WI-673206",2005,155,80,10.4538744594595,75
"8578","WI-673206",2006,146,82,10.0826563492063,64
"8579","WI-673206",2007,150,100,13.0559732653061,50
"8580","WI-673206",2008,156,86,10.040421884058,70
"8581","WI-673206",2009,169,73,10.0101229473684,96
"8582","WI-673206",2010,143,65,9.17038077922078,78
"8583","WI-673206",2011,153,88,10.23509921875,65
"8584","WI-673206",2012,166,63,12.436417254902,103
"8585","WI-673206",2013,165,84,10.564949,81
"8586","WI-673206",2014,150,86,9.997,64
"8587","WI-673206",2015,163,86,12.1700976315789,77
"8588","WI-673206",2016,146,64,8.19155037037037,82
"8589","WI-673206",2017,160,77,11.0656219512195,83
"8590","WI-673206",2018,145,108,12.7213708333333,37
"8591","WI-673206",2019,175,70,10.2328908653846,105
"8592","WI-673206",2020,146,65,6.689203875,81
"8593","WI-673206",2021,140,65,8.50762662162162,75
"8594","WI-673206",2022,131,89,7.53506414634146,42
"8595","WI-673206",2023,150,76,9.36989657534247,74
"8596","WI-673208",1979,190,101,12.8536681818182,89
"8597","WI-673208",1980,175,88,11.7119047674419,87
"8598","WI-673208",1981,163,84,9.09144448717949,79
"8599","WI-673208",1982,185,102,13.8097943902439,83
"8600","WI-673208",1983,163,110,10.09629,53
"8601","WI-673208",1984,157,92,9.3421134375,65
"8602","WI-673208",1985,183,82,12.7837889,101
"8603","WI-673208",1986,175,83,12.394157032967,92
"8604","WI-673208",1987,148,92,11.3406532727273,56
"8605","WI-673208",1988,150,81,9.09222794117647,69
"8606","WI-673208",1989,171,81,10.6182291011236,90
"8607","WI-673208",1990,163,85,10.0452703896104,78
"8608","WI-673208",1991,133,74,8.06491172413793,59
"8609","WI-673208",1992,220,84,12.9722324444444,136
"8610","WI-673208",1993,184,81,10.8762181372549,103
"8611","WI-673208",1994,164,77,9.33488988372093,87
"8612","WI-673208",1995,166,97,10.6149575,69
"8613","WI-673208",1996,179,99,11.0947563291139,80
"8614","WI-673208",1997,171,101,10.5542944927536,70
"8615","WI-673208",1998,136,81,9.94066574074074,55
"8616","WI-673208",1999,157,75,10.3270519753086,82
"8617","WI-673208",2000,163,51,9.36633054054054,112
"8618","WI-673208",2001,161,87,11.2503856164384,74
"8619","WI-673208",2002,171,94,11.4941161842105,77
"8620","WI-673208",2003,173,98,12.1911078378378,75
"8621","WI-673208",2004,193,80,12.8102261607143,113
"8622","WI-673208",2005,155,81,10.2276554794521,74
"8623","WI-673208",2006,146,82,9.79421476190476,64
"8624","WI-673208",2007,151,100,12.8679704,51
"8625","WI-673208",2008,157,86,9.73607671428571,71
"8626","WI-673208",2009,169,73,9.60823221052632,96
"8627","WI-673208",2010,143,66,8.9530075,77
"8628","WI-673208",2011,155,88,9.9448246969697,67
"8629","WI-673208",2012,168,63,12.0717453846154,105
"8630","WI-673208",2013,172,84,10.6913220689655,88
"8631","WI-673208",2014,169,86,11.4538613414634,83
"8632","WI-673208",2015,172,86,12.4579811764706,86
"8633","WI-673208",2016,146,64,7.67544358024691,82
"8634","WI-673208",2017,161,77,10.7173345783133,84
"8635","WI-673208",2018,145,108,12.3832619444444,37
"8636","WI-673208",2019,176,73,10.0672206862745,103
"8637","WI-673208",2020,146,67,6.35391730769231,79
"8638","WI-673208",2021,140,66,8.21164273972603,74
"8639","WI-673208",2022,131,89,7.08117853658537,42
"8640","WI-673208",2023,150,76,9.08511506849315,74
"8641","WI-673225",1979,169,99,12.6095534782609,70
"8642","WI-673225",1980,175,85,11.7864066292135,90
"8643","WI-673225",1981,163,80,10.7676124390244,83
"8644","WI-673225",1982,134,102,10.9687906451613,32
"8645","WI-673225",1983,162,91,8.47311428571428,71
"8646","WI-673225",1984,156,92,9.55930158730159,64
"8647","WI-673225",1985,180,78,12.6667630693069,102
"8648","WI-673225",1986,170,82,12.334397816092,88
"8649","WI-673225",1987,148,92,11.7108232727273,56
"8650","WI-673225",1988,150,81,9.52168485294118,69
"8651","WI-673225",1989,171,81,11.2950207865169,90
"8652","WI-673225",1990,162,85,10.3569780263158,77
"8653","WI-673225",1991,133,73,8.43195694915254,60
"8654","WI-673225",1992,166,84,10.2626345679012,82
"8655","WI-673225",1993,172,80,10.3629510989011,92
"8656","WI-673225",1994,163,76,9.6239161627907,87
"8657","WI-673225",1995,166,68,8.86999381443299,98
"8658","WI-673225",1996,179,98,11.419872,81
"8659","WI-673225",1997,170,101,10.8089580882353,69
"8660","WI-673225",1998,136,81,10.4279340740741,55
"8661","WI-673225",1999,156,75,10.556469625,81
"8662","WI-673225",2000,163,51,9.84232963963964,112
"8663","WI-673225",2001,161,87,11.6729024657534,74
"8664","WI-673225",2002,161,94,11.022595,67
"8665","WI-673225",2003,173,98,12.5956683783784,75
"8666","WI-673225",2004,161,79,11.5656092592593,82
"8667","WI-673225",2005,155,80,10.4538744594595,75
"8668","WI-673225",2006,146,82,10.0826563492063,64
"8669","WI-673225",2007,150,100,13.0559732653061,50
"8670","WI-673225",2008,156,86,10.040421884058,70
"8671","WI-673225",2009,169,73,10.0101229473684,96
"8672","WI-673225",2010,143,65,9.17038077922078,78
"8673","WI-673225",2011,153,88,10.23509921875,65
"8674","WI-673225",2012,166,63,12.436417254902,103
"8675","WI-673225",2013,165,84,10.564949,81
"8676","WI-673225",2014,150,86,9.997,64
"8677","WI-673225",2015,163,86,12.1700976315789,77
"8678","WI-673225",2016,146,64,8.19155037037037,82
"8679","WI-673225",2017,160,77,11.0656219512195,83
"8680","WI-673225",2018,145,108,12.7213708333333,37
"8681","WI-673225",2019,175,70,10.2328908653846,105
"8682","WI-673225",2020,146,65,6.689203875,81
"8683","WI-673225",2021,140,65,8.50762662162162,75
"8684","WI-673225",2022,131,89,7.53506414634146,42
"8685","WI-673225",2023,150,76,9.36989657534247,74
"8686","WI-673250",1979,169,99,12.6095534782609,70
"8687","WI-673250",1980,175,85,11.7864066292135,90
"8688","WI-673250",1981,163,80,10.7676124390244,83
"8689","WI-673250",1982,134,102,10.9687906451613,32
"8690","WI-673250",1983,162,91,8.47311428571428,71
"8691","WI-673250",1984,156,92,9.55930158730159,64
"8692","WI-673250",1985,180,78,12.6667630693069,102
"8693","WI-673250",1986,170,82,12.334397816092,88
"8694","WI-673250",1987,148,92,11.7108232727273,56
"8695","WI-673250",1988,150,81,9.52168485294118,69
"8696","WI-673250",1989,171,81,11.2950207865169,90
"8697","WI-673250",1990,162,85,10.3569780263158,77
"8698","WI-673250",1991,133,73,8.43195694915254,60
"8699","WI-673250",1992,166,84,10.2626345679012,82
"8700","WI-673250",1993,172,80,10.3629510989011,92
"8701","WI-673250",1994,163,76,9.6239161627907,87
"8702","WI-673250",1995,166,68,8.86999381443299,98
"8703","WI-673250",1996,179,98,11.419872,81
"8704","WI-673250",1997,170,101,10.8089580882353,69
"8705","WI-673250",1998,136,81,10.4279340740741,55
"8706","WI-673250",1999,156,75,10.556469625,81
"8707","WI-673250",2000,163,51,9.84232963963964,112
"8708","WI-673250",2001,161,87,11.6729024657534,74
"8709","WI-673250",2002,161,94,11.022595,67
"8710","WI-673250",2003,173,98,12.5956683783784,75
"8711","WI-673250",2004,161,79,11.5656092592593,82
"8712","WI-673250",2005,155,80,10.4538744594595,75
"8713","WI-673250",2006,146,82,10.0826563492063,64
"8714","WI-673250",2007,150,100,13.0559732653061,50
"8715","WI-673250",2008,156,86,10.040421884058,70
"8716","WI-673250",2009,169,73,10.0101229473684,96
"8717","WI-673250",2010,143,65,9.17038077922078,78
"8718","WI-673250",2011,153,88,10.23509921875,65
"8719","WI-673250",2012,166,63,12.436417254902,103
"8720","WI-673250",2013,165,84,10.564949,81
"8721","WI-673250",2014,150,86,9.997,64
"8722","WI-673250",2015,163,86,12.1700976315789,77
"8723","WI-673250",2016,146,64,8.19155037037037,82
"8724","WI-673250",2017,160,77,11.0656219512195,83
"8725","WI-673250",2018,145,108,12.7213708333333,37
"8726","WI-673250",2019,175,70,10.2328908653846,105
"8727","WI-673250",2020,146,65,6.689203875,81
"8728","WI-673250",2021,140,65,8.50762662162162,75
"8729","WI-673250",2022,131,89,7.53506414634146,42
"8730","WI-673250",2023,150,76,9.36989657534247,74
"8731","WI-683123",1979,157,100,10.55533125,57
"8732","WI-683123",1980,175,88,12.4297472093023,87
"8733","WI-683123",1981,156,83,8.89785291666667,73
"8734","WI-683123",1982,133,102,11.137163,31
"8735","WI-683123",1983,161,110,10.5738764,51
"8736","WI-683123",1984,156,92,9.65391968253968,64
"8737","WI-683123",1985,175,82,13.1281569565217,93
"8738","WI-683123",1986,169,83,12.3956534117647,86
"8739","WI-683123",1987,148,92,12.0555672727273,56
"8740","WI-683123",1988,150,80,9.54280173913043,70
"8741","WI-683123",1989,153,81,10.0163112676056,72
"8742","WI-683123",1990,162,85,10.5488977631579,77
"8743","WI-683123",1991,132,75,8.86555892857143,57
"8744","WI-683123",1992,165,85,10.4597450632911,80
"8745","WI-683123",1993,162,81,9.879578625,81
"8746","WI-683123",1994,163,77,10.1016130588235,86
"8747","WI-683123",1995,166,68,9.19819989690722,98
"8748","WI-683123",1996,166,98,10.5520792537313,68
"8749","WI-683123",1997,170,101,11.1884388235294,69
"8750","WI-683123",1998,136,80,10.6296856363636,56
"8751","WI-683123",1999,155,75,10.8005606329114,80
"8752","WI-683123",2000,162,51,10.1119036363636,111
"8753","WI-683123",2001,161,87,12.1085831506849,74
"8754","WI-683123",2002,160,86,10.310074109589,74
"8755","WI-683123",2003,173,98,13.0565010810811,75
"8756","WI-683123",2004,158,76,11.3243427160494,82
"8757","WI-683123",2005,155,79,10.6442649333333,76
"8758","WI-683123",2006,146,82,10.3460498412698,64
"8759","WI-683123",2007,149,100,13.3109445833333,49
"8760","WI-683123",2008,155,83,9.97705464788732,72
"8761","WI-683123",2009,168,72,10.2457908421053,96
"8762","WI-683123",2010,143,65,9.61944701298701,78
"8763","WI-683123",2011,152,88,10.6092406349206,64
"8764","WI-683123",2012,160,62,12.313692371134,98
"8765","WI-683123",2013,164,85,11.0227894871795,79
"8766","WI-683123",2014,149,86,10.5300120967742,63
"8767","WI-683123",2015,158,85,11.8928388888889,73
"8768","WI-683123",2016,145,64,8.59646925,81
"8769","WI-683123",2017,160,77,11.5773412195122,83
"8770","WI-683123",2018,145,108,13.1048344444444,37
"8771","WI-683123",2019,175,70,10.8279181730769,105
"8772","WI-683123",2020,146,66,7.32382873417721,80
"8773","WI-683123",2021,140,66,8.98925301369863,74
"8774","WI-683123",2022,131,88,7.92943333333333,43
"8775","WI-683123",2023,150,76,9.6754401369863,74
"8776","WI-683125",1979,157,100,10.55533125,57
"8777","WI-683125",1980,175,88,12.4297472093023,87
"8778","WI-683125",1981,156,83,8.89785291666667,73
"8779","WI-683125",1982,133,102,11.137163,31
"8780","WI-683125",1983,161,110,10.5738764,51
"8781","WI-683125",1984,156,92,9.65391968253968,64
"8782","WI-683125",1985,175,82,13.1281569565217,93
"8783","WI-683125",1986,169,83,12.3956534117647,86
"8784","WI-683125",1987,148,92,12.0555672727273,56
"8785","WI-683125",1988,150,80,9.54280173913043,70
"8786","WI-683125",1989,153,81,10.0163112676056,72
"8787","WI-683125",1990,162,85,10.5488977631579,77
"8788","WI-683125",1991,132,75,8.86555892857143,57
"8789","WI-683125",1992,165,85,10.4597450632911,80
"8790","WI-683125",1993,162,81,9.879578625,81
"8791","WI-683125",1994,163,77,10.1016130588235,86
"8792","WI-683125",1995,166,68,9.19819989690722,98
"8793","WI-683125",1996,166,98,10.5520792537313,68
"8794","WI-683125",1997,170,101,11.1884388235294,69
"8795","WI-683125",1998,136,80,10.6296856363636,56
"8796","WI-683125",1999,155,75,10.8005606329114,80
"8797","WI-683125",2000,162,51,10.1119036363636,111
"8798","WI-683125",2001,161,87,12.1085831506849,74
"8799","WI-683125",2002,160,86,10.310074109589,74
"8800","WI-683125",2003,173,98,13.0565010810811,75
"8801","WI-683125",2004,158,76,11.3243427160494,82
"8802","WI-683125",2005,155,79,10.6442649333333,76
"8803","WI-683125",2006,146,82,10.3460498412698,64
"8804","WI-683125",2007,149,100,13.3109445833333,49
"8805","WI-683125",2008,155,83,9.97705464788732,72
"8806","WI-683125",2009,168,72,10.2457908421053,96
"8807","WI-683125",2010,143,65,9.61944701298701,78
"8808","WI-683125",2011,152,88,10.6092406349206,64
"8809","WI-683125",2012,160,62,12.313692371134,98
"8810","WI-683125",2013,164,85,11.0227894871795,79
"8811","WI-683125",2014,149,86,10.5300120967742,63
"8812","WI-683125",2015,158,85,11.8928388888889,73
"8813","WI-683125",2016,145,64,8.59646925,81
"8814","WI-683125",2017,160,77,11.5773412195122,83
"8815","WI-683125",2018,145,108,13.1048344444444,37
"8816","WI-683125",2019,175,70,10.8279181730769,105
"8817","WI-683125",2020,146,66,7.32382873417721,80
"8818","WI-683125",2021,140,66,8.98925301369863,74
"8819","WI-683125",2022,131,88,7.92943333333333,43
"8820","WI-683125",2023,150,76,9.6754401369863,74
"8821","WI-683129",1979,157,100,10.55533125,57
"8822","WI-683129",1980,175,88,12.4297472093023,87
"8823","WI-683129",1981,156,83,8.89785291666667,73
"8824","WI-683129",1982,133,102,11.137163,31
"8825","WI-683129",1983,161,110,10.5738764,51
"8826","WI-683129",1984,156,92,9.65391968253968,64
"8827","WI-683129",1985,175,82,13.1281569565217,93
"8828","WI-683129",1986,169,83,12.3956534117647,86
"8829","WI-683129",1987,148,92,12.0555672727273,56
"8830","WI-683129",1988,150,80,9.54280173913043,70
"8831","WI-683129",1989,153,81,10.0163112676056,72
"8832","WI-683129",1990,162,85,10.5488977631579,77
"8833","WI-683129",1991,132,75,8.86555892857143,57
"8834","WI-683129",1992,165,85,10.4597450632911,80
"8835","WI-683129",1993,162,81,9.879578625,81
"8836","WI-683129",1994,163,77,10.1016130588235,86
"8837","WI-683129",1995,166,68,9.19819989690722,98
"8838","WI-683129",1996,166,98,10.5520792537313,68
"8839","WI-683129",1997,170,101,11.1884388235294,69
"8840","WI-683129",1998,136,80,10.6296856363636,56
"8841","WI-683129",1999,155,75,10.8005606329114,80
"8842","WI-683129",2000,162,51,10.1119036363636,111
"8843","WI-683129",2001,161,87,12.1085831506849,74
"8844","WI-683129",2002,160,86,10.310074109589,74
"8845","WI-683129",2003,173,98,13.0565010810811,75
"8846","WI-683129",2004,158,76,11.3243427160494,82
"8847","WI-683129",2005,155,79,10.6442649333333,76
"8848","WI-683129",2006,146,82,10.3460498412698,64
"8849","WI-683129",2007,149,100,13.3109445833333,49
"8850","WI-683129",2008,155,83,9.97705464788732,72
"8851","WI-683129",2009,168,72,10.2457908421053,96
"8852","WI-683129",2010,143,65,9.61944701298701,78
"8853","WI-683129",2011,152,88,10.6092406349206,64
"8854","WI-683129",2012,160,62,12.313692371134,98
"8855","WI-683129",2013,164,85,11.0227894871795,79
"8856","WI-683129",2014,149,86,10.5300120967742,63
"8857","WI-683129",2015,158,85,11.8928388888889,73
"8858","WI-683129",2016,145,64,8.59646925,81
"8859","WI-683129",2017,160,77,11.5773412195122,83
"8860","WI-683129",2018,145,108,13.1048344444444,37
"8861","WI-683129",2019,175,70,10.8279181730769,105
"8862","WI-683129",2020,146,66,7.32382873417721,80
"8863","WI-683129",2021,140,66,8.98925301369863,74
"8864","WI-683129",2022,131,88,7.92943333333333,43
"8865","WI-683129",2023,150,76,9.6754401369863,74
"8866","WI-683137",1979,157,100,10.55533125,57
"8867","WI-683137",1980,175,88,12.4297472093023,87
"8868","WI-683137",1981,156,83,8.89785291666667,73
"8869","WI-683137",1982,133,102,11.137163,31
"8870","WI-683137",1983,161,110,10.5738764,51
"8871","WI-683137",1984,156,92,9.65391968253968,64
"8872","WI-683137",1985,175,82,13.1281569565217,93
"8873","WI-683137",1986,169,83,12.3956534117647,86
"8874","WI-683137",1987,148,92,12.0555672727273,56
"8875","WI-683137",1988,150,80,9.54280173913043,70
"8876","WI-683137",1989,153,81,10.0163112676056,72
"8877","WI-683137",1990,162,85,10.5488977631579,77
"8878","WI-683137",1991,132,75,8.86555892857143,57
"8879","WI-683137",1992,165,85,10.4597450632911,80
"8880","WI-683137",1993,162,81,9.879578625,81
"8881","WI-683137",1994,163,77,10.1016130588235,86
"8882","WI-683137",1995,166,68,9.19819989690722,98
"8883","WI-683137",1996,166,98,10.5520792537313,68
"8884","WI-683137",1997,170,101,11.1884388235294,69
"8885","WI-683137",1998,136,80,10.6296856363636,56
"8886","WI-683137",1999,155,75,10.8005606329114,80
"8887","WI-683137",2000,162,51,10.1119036363636,111
"8888","WI-683137",2001,161,87,12.1085831506849,74
"8889","WI-683137",2002,160,86,10.310074109589,74
"8890","WI-683137",2003,173,98,13.0565010810811,75
"8891","WI-683137",2004,158,76,11.3243427160494,82
"8892","WI-683137",2005,155,79,10.6442649333333,76
"8893","WI-683137",2006,146,82,10.3460498412698,64
"8894","WI-683137",2007,149,100,13.3109445833333,49
"8895","WI-683137",2008,155,83,9.97705464788732,72
"8896","WI-683137",2009,168,72,10.2457908421053,96
"8897","WI-683137",2010,143,65,9.61944701298701,78
"8898","WI-683137",2011,152,88,10.6092406349206,64
"8899","WI-683137",2012,160,62,12.313692371134,98
"8900","WI-683137",2013,164,85,11.0227894871795,79
"8901","WI-683137",2014,149,86,10.5300120967742,63
"8902","WI-683137",2015,158,85,11.8928388888889,73
"8903","WI-683137",2016,145,64,8.59646925,81
"8904","WI-683137",2017,160,77,11.5773412195122,83
"8905","WI-683137",2018,145,108,13.1048344444444,37
"8906","WI-683137",2019,175,70,10.8279181730769,105
"8907","WI-683137",2020,146,66,7.32382873417721,80
"8908","WI-683137",2021,140,66,8.98925301369863,74
"8909","WI-683137",2022,131,88,7.92943333333333,43
"8910","WI-683137",2023,150,76,9.6754401369863,74
"8911","WI-683143",1979,157,100,10.55533125,57
"8912","WI-683143",1980,175,88,12.4297472093023,87
"8913","WI-683143",1981,156,83,8.89785291666667,73
"8914","WI-683143",1982,133,102,11.137163,31
"8915","WI-683143",1983,161,110,10.5738764,51
"8916","WI-683143",1984,156,92,9.65391968253968,64
"8917","WI-683143",1985,175,82,13.1281569565217,93
"8918","WI-683143",1986,169,83,12.3956534117647,86
"8919","WI-683143",1987,148,92,12.0555672727273,56
"8920","WI-683143",1988,150,80,9.54280173913043,70
"8921","WI-683143",1989,153,81,10.0163112676056,72
"8922","WI-683143",1990,162,85,10.5488977631579,77
"8923","WI-683143",1991,132,75,8.86555892857143,57
"8924","WI-683143",1992,165,85,10.4597450632911,80
"8925","WI-683143",1993,162,81,9.879578625,81
"8926","WI-683143",1994,163,77,10.1016130588235,86
"8927","WI-683143",1995,166,68,9.19819989690722,98
"8928","WI-683143",1996,166,98,10.5520792537313,68
"8929","WI-683143",1997,170,101,11.1884388235294,69
"8930","WI-683143",1998,136,80,10.6296856363636,56
"8931","WI-683143",1999,155,75,10.8005606329114,80
"8932","WI-683143",2000,162,51,10.1119036363636,111
"8933","WI-683143",2001,161,87,12.1085831506849,74
"8934","WI-683143",2002,160,86,10.310074109589,74
"8935","WI-683143",2003,173,98,13.0565010810811,75
"8936","WI-683143",2004,158,76,11.3243427160494,82
"8937","WI-683143",2005,155,79,10.6442649333333,76
"8938","WI-683143",2006,146,82,10.3460498412698,64
"8939","WI-683143",2007,149,100,13.3109445833333,49
"8940","WI-683143",2008,155,83,9.97705464788732,72
"8941","WI-683143",2009,168,72,10.2457908421053,96
"8942","WI-683143",2010,143,65,9.61944701298701,78
"8943","WI-683143",2011,152,88,10.6092406349206,64
"8944","WI-683143",2012,160,62,12.313692371134,98
"8945","WI-683143",2013,164,85,11.0227894871795,79
"8946","WI-683143",2014,149,86,10.5300120967742,63
"8947","WI-683143",2015,158,85,11.8928388888889,73
"8948","WI-683143",2016,145,64,8.59646925,81
"8949","WI-683143",2017,160,77,11.5773412195122,83
"8950","WI-683143",2018,145,108,13.1048344444444,37
"8951","WI-683143",2019,175,70,10.8279181730769,105
"8952","WI-683143",2020,146,66,7.32382873417721,80
"8953","WI-683143",2021,140,66,8.98925301369863,74
"8954","WI-683143",2022,131,88,7.92943333333333,43
"8955","WI-683143",2023,150,76,9.6754401369863,74
"8956","WI-683145",1979,157,100,10.55533125,57
"8957","WI-683145",1980,175,88,12.4297472093023,87
"8958","WI-683145",1981,156,83,8.89785291666667,73
"8959","WI-683145",1982,133,102,11.137163,31
"8960","WI-683145",1983,161,110,10.5738764,51
"8961","WI-683145",1984,156,92,9.65391968253968,64
"8962","WI-683145",1985,175,82,13.1281569565217,93
"8963","WI-683145",1986,169,83,12.3956534117647,86
"8964","WI-683145",1987,148,92,12.0555672727273,56
"8965","WI-683145",1988,150,80,9.54280173913043,70
"8966","WI-683145",1989,153,81,10.0163112676056,72
"8967","WI-683145",1990,162,85,10.5488977631579,77
"8968","WI-683145",1991,132,75,8.86555892857143,57
"8969","WI-683145",1992,165,85,10.4597450632911,80
"8970","WI-683145",1993,162,81,9.879578625,81
"8971","WI-683145",1994,163,77,10.1016130588235,86
"8972","WI-683145",1995,166,68,9.19819989690722,98
"8973","WI-683145",1996,166,98,10.5520792537313,68
"8974","WI-683145",1997,170,101,11.1884388235294,69
"8975","WI-683145",1998,136,80,10.6296856363636,56
"8976","WI-683145",1999,155,75,10.8005606329114,80
"8977","WI-683145",2000,162,51,10.1119036363636,111
"8978","WI-683145",2001,161,87,12.1085831506849,74
"8979","WI-683145",2002,160,86,10.310074109589,74
"8980","WI-683145",2003,173,98,13.0565010810811,75
"8981","WI-683145",2004,158,76,11.3243427160494,82
"8982","WI-683145",2005,155,79,10.6442649333333,76
"8983","WI-683145",2006,146,82,10.3460498412698,64
"8984","WI-683145",2007,149,100,13.3109445833333,49
"8985","WI-683145",2008,155,83,9.97705464788732,72
"8986","WI-683145",2009,168,72,10.2457908421053,96
"8987","WI-683145",2010,143,65,9.61944701298701,78
"8988","WI-683145",2011,152,88,10.6092406349206,64
"8989","WI-683145",2012,160,62,12.313692371134,98
"8990","WI-683145",2013,164,85,11.0227894871795,79
"8991","WI-683145",2014,149,86,10.5300120967742,63
"8992","WI-683145",2015,158,85,11.8928388888889,73
"8993","WI-683145",2016,145,64,8.59646925,81
"8994","WI-683145",2017,160,77,11.5773412195122,83
"8995","WI-683145",2018,145,108,13.1048344444444,37
"8996","WI-683145",2019,175,70,10.8279181730769,105
"8997","WI-683145",2020,146,66,7.32382873417721,80
"8998","WI-683145",2021,140,66,8.98925301369863,74
"8999","WI-683145",2022,131,88,7.92943333333333,43
"9000","WI-683145",2023,150,76,9.6754401369863,74
"9001","WI-683201",1979,157,100,10.55533125,57
"9002","WI-683201",1980,175,88,12.4297472093023,87
"9003","WI-683201",1981,156,83,8.89785291666667,73
"9004","WI-683201",1982,133,102,11.137163,31
"9005","WI-683201",1983,161,110,10.5738764,51
"9006","WI-683201",1984,156,92,9.65391968253968,64
"9007","WI-683201",1985,175,82,13.1281569565217,93
"9008","WI-683201",1986,169,83,12.3956534117647,86
"9009","WI-683201",1987,148,92,12.0555672727273,56
"9010","WI-683201",1988,150,80,9.54280173913043,70
"9011","WI-683201",1989,153,81,10.0163112676056,72
"9012","WI-683201",1990,162,85,10.5488977631579,77
"9013","WI-683201",1991,132,75,8.86555892857143,57
"9014","WI-683201",1992,165,85,10.4597450632911,80
"9015","WI-683201",1993,162,81,9.879578625,81
"9016","WI-683201",1994,163,77,10.1016130588235,86
"9017","WI-683201",1995,166,68,9.19819989690722,98
"9018","WI-683201",1996,166,98,10.5520792537313,68
"9019","WI-683201",1997,170,101,11.1884388235294,69
"9020","WI-683201",1998,136,80,10.6296856363636,56
"9021","WI-683201",1999,155,75,10.8005606329114,80
"9022","WI-683201",2000,162,51,10.1119036363636,111
"9023","WI-683201",2001,161,87,12.1085831506849,74
"9024","WI-683201",2002,160,86,10.310074109589,74
"9025","WI-683201",2003,173,98,13.0565010810811,75
"9026","WI-683201",2004,158,76,11.3243427160494,82
"9027","WI-683201",2005,155,79,10.6442649333333,76
"9028","WI-683201",2006,146,82,10.3460498412698,64
"9029","WI-683201",2007,149,100,13.3109445833333,49
"9030","WI-683201",2008,155,83,9.97705464788732,72
"9031","WI-683201",2009,168,72,10.2457908421053,96
"9032","WI-683201",2010,143,65,9.61944701298701,78
"9033","WI-683201",2011,152,88,10.6092406349206,64
"9034","WI-683201",2012,160,62,12.313692371134,98
"9035","WI-683201",2013,164,85,11.0227894871795,79
"9036","WI-683201",2014,149,86,10.5300120967742,63
"9037","WI-683201",2015,158,85,11.8928388888889,73
"9038","WI-683201",2016,145,64,8.59646925,81
"9039","WI-683201",2017,160,77,11.5773412195122,83
"9040","WI-683201",2018,145,108,13.1048344444444,37
"9041","WI-683201",2019,175,70,10.8279181730769,105
"9042","WI-683201",2020,146,66,7.32382873417721,80
"9043","WI-683201",2021,140,66,8.98925301369863,74
"9044","WI-683201",2022,131,88,7.92943333333333,43
"9045","WI-683201",2023,150,76,9.6754401369863,74
"9046","WI-683202",1979,157,100,10.55533125,57
"9047","WI-683202",1980,175,88,12.4297472093023,87
"9048","WI-683202",1981,156,83,8.89785291666667,73
"9049","WI-683202",1982,133,102,11.137163,31
"9050","WI-683202",1983,161,110,10.5738764,51
"9051","WI-683202",1984,156,92,9.65391968253968,64
"9052","WI-683202",1985,175,82,13.1281569565217,93
"9053","WI-683202",1986,169,83,12.3956534117647,86
"9054","WI-683202",1987,148,92,12.0555672727273,56
"9055","WI-683202",1988,150,80,9.54280173913043,70
"9056","WI-683202",1989,153,81,10.0163112676056,72
"9057","WI-683202",1990,162,85,10.5488977631579,77
"9058","WI-683202",1991,132,75,8.86555892857143,57
"9059","WI-683202",1992,165,85,10.4597450632911,80
"9060","WI-683202",1993,162,81,9.879578625,81
"9061","WI-683202",1994,163,77,10.1016130588235,86
"9062","WI-683202",1995,166,68,9.19819989690722,98
"9063","WI-683202",1996,166,98,10.5520792537313,68
"9064","WI-683202",1997,170,101,11.1884388235294,69
"9065","WI-683202",1998,136,80,10.6296856363636,56
"9066","WI-683202",1999,155,75,10.8005606329114,80
"9067","WI-683202",2000,162,51,10.1119036363636,111
"9068","WI-683202",2001,161,87,12.1085831506849,74
"9069","WI-683202",2002,160,86,10.310074109589,74
"9070","WI-683202",2003,173,98,13.0565010810811,75
"9071","WI-683202",2004,158,76,11.3243427160494,82
"9072","WI-683202",2005,155,79,10.6442649333333,76
"9073","WI-683202",2006,146,82,10.3460498412698,64
"9074","WI-683202",2007,149,100,13.3109445833333,49
"9075","WI-683202",2008,155,83,9.97705464788732,72
"9076","WI-683202",2009,168,72,10.2457908421053,96
"9077","WI-683202",2010,143,65,9.61944701298701,78
"9078","WI-683202",2011,152,88,10.6092406349206,64
"9079","WI-683202",2012,160,62,12.313692371134,98
"9080","WI-683202",2013,164,85,11.0227894871795,79
"9081","WI-683202",2014,149,86,10.5300120967742,63
"9082","WI-683202",2015,158,85,11.8928388888889,73
"9083","WI-683202",2016,145,64,8.59646925,81
"9084","WI-683202",2017,160,77,11.5773412195122,83
"9085","WI-683202",2018,145,108,13.1048344444444,37
"9086","WI-683202",2019,175,70,10.8279181730769,105
"9087","WI-683202",2020,146,66,7.32382873417721,80
"9088","WI-683202",2021,140,66,8.98925301369863,74
"9089","WI-683202",2022,131,88,7.92943333333333,43
"9090","WI-683202",2023,150,76,9.6754401369863,74
"9091","WI-683256",1979,157,100,10.55533125,57
"9092","WI-683256",1980,175,88,12.4297472093023,87
"9093","WI-683256",1981,156,83,8.89785291666667,73
"9094","WI-683256",1982,133,102,11.137163,31
"9095","WI-683256",1983,161,110,10.5738764,51
"9096","WI-683256",1984,156,92,9.65391968253968,64
"9097","WI-683256",1985,175,82,13.1281569565217,93
"9098","WI-683256",1986,169,83,12.3956534117647,86
"9099","WI-683256",1987,148,92,12.0555672727273,56
"9100","WI-683256",1988,150,80,9.54280173913043,70
"9101","WI-683256",1989,153,81,10.0163112676056,72
"9102","WI-683256",1990,162,85,10.5488977631579,77
"9103","WI-683256",1991,132,75,8.86555892857143,57
"9104","WI-683256",1992,165,85,10.4597450632911,80
"9105","WI-683256",1993,162,81,9.879578625,81
"9106","WI-683256",1994,163,77,10.1016130588235,86
"9107","WI-683256",1995,166,68,9.19819989690722,98
"9108","WI-683256",1996,166,98,10.5520792537313,68
"9109","WI-683256",1997,170,101,11.1884388235294,69
"9110","WI-683256",1998,136,80,10.6296856363636,56
"9111","WI-683256",1999,155,75,10.8005606329114,80
"9112","WI-683256",2000,162,51,10.1119036363636,111
"9113","WI-683256",2001,161,87,12.1085831506849,74
"9114","WI-683256",2002,160,86,10.310074109589,74
"9115","WI-683256",2003,173,98,13.0565010810811,75
"9116","WI-683256",2004,158,76,11.3243427160494,82
"9117","WI-683256",2005,155,79,10.6442649333333,76
"9118","WI-683256",2006,146,82,10.3460498412698,64
"9119","WI-683256",2007,149,100,13.3109445833333,49
"9120","WI-683256",2008,155,83,9.97705464788732,72
"9121","WI-683256",2009,168,72,10.2457908421053,96
"9122","WI-683256",2010,143,65,9.61944701298701,78
"9123","WI-683256",2011,152,88,10.6092406349206,64
"9124","WI-683256",2012,160,62,12.313692371134,98
"9125","WI-683256",2013,164,85,11.0227894871795,79
"9126","WI-683256",2014,149,86,10.5300120967742,63
"9127","WI-683256",2015,158,85,11.8928388888889,73
"9128","WI-683256",2016,145,64,8.59646925,81
"9129","WI-683256",2017,160,77,11.5773412195122,83
"9130","WI-683256",2018,145,108,13.1048344444444,37
"9131","WI-683256",2019,175,70,10.8279181730769,105
"9132","WI-683256",2020,146,66,7.32382873417721,80
"9133","WI-683256",2021,140,66,8.98925301369863,74
"9134","WI-683256",2022,131,88,7.92943333333333,43
"9135","WI-683256",2023,150,76,9.6754401369863,74
"9136","WI-683260",1979,157,99,11.8174952631579,58
"9137","WI-683260",1980,152,84,10.2723188059701,68
"9138","WI-683260",1981,156,82,9.30335273972603,74
"9139","WI-683260",1982,133,101,11.1176106451613,32
"9140","WI-683260",1983,161,110,10.8707518,51
"9141","WI-683260",1984,156,92,9.74060095238095,64
"9142","WI-683260",1985,175,81,13.1694209677419,94
"9143","WI-683260",1986,169,83,12.7355427058824,86
"9144","WI-683260",1987,148,92,12.206278,56
"9145","WI-683260",1988,150,80,9.70924173913044,70
"9146","WI-683260",1989,153,81,10.4501801408451,72
"9147","WI-683260",1990,162,85,10.7824503947368,77
"9148","WI-683260",1991,132,74,8.96133631578947,58
"9149","WI-683260",1992,165,84,10.533390875,81
"9150","WI-683260",1993,162,80,9.98785740740741,82
"9151","WI-683260",1994,163,76,10.1294570930233,87
"9152","WI-683260",1995,166,68,9.3963312371134,98
"9153","WI-683260",1996,166,98,10.8028947761194,68
"9154","WI-683260",1997,169,101,11.2600752238806,68
"9155","WI-683260",1998,135,80,10.6308257407407,55
"9156","WI-683260",1999,155,75,10.9054858227848,80
"9157","WI-683260",2000,127,51,7.7821004,76
"9158","WI-683260",2001,161,87,12.2461049315068,74
"9159","WI-683260",2002,150,86,9.30420666666667,64
"9160","WI-683260",2003,173,98,13.1500390540541,75
"9161","WI-683260",2004,158,76,11.5954662962963,82
"9162","WI-683260",2005,155,79,10.8113485333333,76
"9163","WI-683260",2006,146,82,10.53913,64
"9164","WI-683260",2007,149,99,13.2785283673469,50
"9165","WI-683260",2008,155,82,9.99438333333333,73
"9166","WI-683260",2009,168,71,10.3054691666667,97
"9167","WI-683260",2010,143,65,9.80491753246753,78
"9168","WI-683260",2011,152,88,10.8735019047619,64
"9169","WI-683260",2012,80,59,7.991548,21
"9170","WI-683260",2013,163,84,11.1226191025641,79
"9171","WI-683260",2014,149,86,10.849695483871,63
"9172","WI-683260",2015,158,85,12.1281905555556,73
"9173","WI-683260",2016,145,64,8.878695375,81
"9174","WI-683260",2017,160,77,11.8525892682927,83
"9175","WI-683260",2018,145,107,12.9486221621622,38
"9176","WI-683260",2019,175,69,10.9902608571429,106
"9177","WI-683260",2020,145,64,7.28161375,81
"9178","WI-683260",2021,140,65,9.06738135135135,75
"9179","WI-683260",2022,131,72,7.26577275862069,59
"9180","WI-683260",2023,150,76,9.90970767123288,74
"9181","WI-683325",1979,157,100,10.55533125,57
"9182","WI-683325",1980,175,88,12.4297472093023,87
"9183","WI-683325",1981,156,83,8.89785291666667,73
"9184","WI-683325",1982,133,102,11.137163,31
"9185","WI-683325",1983,161,110,10.5738764,51
"9186","WI-683325",1984,156,92,9.65391968253968,64
"9187","WI-683325",1985,175,82,13.1281569565217,93
"9188","WI-683325",1986,169,83,12.3956534117647,86
"9189","WI-683325",1987,148,92,12.0555672727273,56
"9190","WI-683325",1988,150,80,9.54280173913043,70
"9191","WI-683325",1989,153,81,10.0163112676056,72
"9192","WI-683325",1990,162,85,10.5488977631579,77
"9193","WI-683325",1991,132,75,8.86555892857143,57
"9194","WI-683325",1992,165,85,10.4597450632911,80
"9195","WI-683325",1993,162,81,9.879578625,81
"9196","WI-683325",1994,163,77,10.1016130588235,86
"9197","WI-683325",1995,166,68,9.19819989690722,98
"9198","WI-683325",1996,166,98,10.5520792537313,68
"9199","WI-683325",1997,170,101,11.1884388235294,69
"9200","WI-683325",1998,136,80,10.6296856363636,56
"9201","WI-683325",1999,155,75,10.8005606329114,80
"9202","WI-683325",2000,162,51,10.1119036363636,111
"9203","WI-683325",2001,161,87,12.1085831506849,74
"9204","WI-683325",2002,160,86,10.310074109589,74
"9205","WI-683325",2003,173,98,13.0565010810811,75
"9206","WI-683325",2004,158,76,11.3243427160494,82
"9207","WI-683325",2005,155,79,10.6442649333333,76
"9208","WI-683325",2006,146,82,10.3460498412698,64
"9209","WI-683325",2007,149,100,13.3109445833333,49
"9210","WI-683325",2008,155,83,9.97705464788732,72
"9211","WI-683325",2009,168,72,10.2457908421053,96
"9212","WI-683325",2010,143,65,9.61944701298701,78
"9213","WI-683325",2011,152,88,10.6092406349206,64
"9214","WI-683325",2012,160,62,12.313692371134,98
"9215","WI-683325",2013,164,85,11.0227894871795,79
"9216","WI-683325",2014,149,86,10.5300120967742,63
"9217","WI-683325",2015,158,85,11.8928388888889,73
"9218","WI-683325",2016,145,64,8.59646925,81
"9219","WI-683325",2017,160,77,11.5773412195122,83
"9220","WI-683325",2018,145,108,13.1048344444444,37
"9221","WI-683325",2019,175,70,10.8279181730769,105
"9222","WI-683325",2020,146,66,7.32382873417721,80
"9223","WI-683325",2021,140,66,8.98925301369863,74
"9224","WI-683325",2022,131,88,7.92943333333333,43
"9225","WI-683325",2023,150,76,9.6754401369863,74
"9226","WI-693025",1979,189,100,12.7663017045455,89
"9227","WI-693025",1980,175,87,11.5790273563218,88
"9228","WI-693025",1981,182,80,11.7061756435644,102
"9229","WI-693025",1982,184,101,13.1243624390244,83
"9230","WI-693025",1983,163,108,10.2172161111111,55
"9231","WI-693025",1984,193,87,11.9254291428571,106
"9232","WI-693025",1985,180,77,11.651722254902,103
"9233","WI-693025",1986,185,83,12.7875305940594,102
"9234","WI-693025",1987,149,92,11.8978308928571,57
"9235","WI-693025",1988,150,83,9.18839439393939,67
"9236","WI-693025",1989,171,100,11.7331025714286,71
"9237","WI-693025",1990,166,86,10.2770089873418,80
"9238","WI-693025",1991,133,75,7.21098263157895,58
"9239","WI-693025",1992,234,85,13.0669018918919,149
"9240","WI-693025",1993,186,81,10.50466375,105
"9241","WI-693025",1994,164,86,9.83051844155844,78
"9242","WI-693025",1995,167,97,10.3889104347826,70
"9243","WI-693025",1996,179,102,10.8209644736842,77
"9244","WI-693025",1997,172,101,10.5235241428571,71
"9245","WI-693025",1998,136,81,10.0821583333333,55
"9246","WI-693025",1999,157,75,10.182472345679,82
"9247","WI-693025",2000,185,52,10.4118458333333,133
"9248","WI-693025",2001,162,88,10.8965819178082,74
"9249","WI-693025",2002,161,96,10.1328321875,65
"9250","WI-693025",2003,173,97,12.1952858666667,76
"9251","WI-693025",2004,193,81,11.9963022522523,112
"9252","WI-693025",2005,155,83,10.0354107042254,72
"9253","WI-693025",2006,146,84,9.3996606557377,62
"9254","WI-693025",2007,152,100,12.8368115686275,52
"9255","WI-693025",2008,187,87,11.8357446464646,100
"9256","WI-693025",2009,169,74,9.16572882978723,95
"9257","WI-693025",2010,143,65,8.69148454545455,78
"9258","WI-693025",2011,156,89,9.56036939393939,67
"9259","WI-693025",2012,168,67,12.0279439,101
"9260","WI-693025",2013,173,94,11.2460643589744,79
"9261","WI-693025",2014,170,88,10.8626744444444,82
"9262","WI-693025",2015,191,86,13.0302855769231,105
"9263","WI-693025",2016,146,98,10.04649,48
"9264","WI-693025",2017,160,76,9.95285638554217,84
"9265","WI-693025",2018,145,108,12.1527938888889,37
"9266","WI-693025",2019,177,82,10.3559137234043,95
"9267","WI-693025",2020,171,81,9.67225808988764,90
"9268","WI-693025",2021,141,66,7.63493540540541,75
"9269","WI-693025",2022,131,90,5.93785625,41
"9270","WI-693025",2023,150,89,10.2546953333333,61
"9271","WI-693034",1979,189,103,13.2473815294118,86
"9272","WI-693034",1980,175,88,12.154401627907,87
"9273","WI-693034",1981,163,95,10.1715313432836,68
"9274","WI-693034",1982,184,102,13.5171033333333,82
"9275","WI-693034",1983,163,108,10.1671587037037,55
"9276","WI-693034",1984,157,93,9.46815412698413,64
"9277","WI-693034",1985,180,83,12.74793625,97
"9278","WI-693034",1986,149,84,10.5915778125,65
"9279","WI-693034",1987,148,92,11.9372438181818,56
"9280","WI-693034",1988,150,82,9.49253731343284,68
"9281","WI-693034",1989,171,82,10.6304229545455,89
"9282","WI-693034",1990,165,85,10.4554758227848,80
"9283","WI-693034",1991,133,75,7.8617501754386,58
"9284","WI-693034",1992,164,84,9.85646341772152,80
"9285","WI-693034",1993,185,81,10.9954408737864,104
"9286","WI-693034",1994,164,77,9.5226626744186,87
"9287","WI-693034",1995,166,97,10.8729997058824,69
"9288","WI-693034",1996,179,100,11.2074308974359,79
"9289","WI-693034",1997,171,101,10.8670208695652,70
"9290","WI-693034",1998,136,81,10.3127722222222,55
"9291","WI-693034",1999,156,74,10.3756845679012,82
"9292","WI-693034",2000,163,51,9.42256612612613,112
"9293","WI-693034",2001,161,87,11.3122426027397,74
"9294","WI-693034",2002,161,95,10.5445629230769,66
"9295","WI-693034",2003,167,97,12.0991576811594,70
"9296","WI-693034",2004,158,80,10.3570646753247,78
"9297","WI-693034",2005,155,82,10.43923625,73
"9298","WI-693034",2006,146,83,9.79659322580645,63
"9299","WI-693034",2007,151,100,13.0807836,51
"9300","WI-693034",2008,159,85,9.86396136986301,74
"9301","WI-693034",2009,168,73,9.65403840425532,95
"9302","WI-693034",2010,142,66,8.99583,76
"9303","WI-693034",2011,155,88,9.7834846969697,67
"9304","WI-693034",2012,168,67,12.5785687,101
"9305","WI-693034",2013,164,92,10.6517914084507,72
"9306","WI-693034",2014,155,87,9.86968865671642,68
"9307","WI-693034",2015,174,86,12.4641786206897,88
"9308","WI-693034",2016,145,65,7.55206696202532,80
"9309","WI-693034",2017,158,76,10.3660818518519,82
"9310","WI-693034",2018,144,108,12.4121242857143,36
"9311","WI-693034",2019,176,79,10.5919663541667,97
"9312","WI-693034",2020,146,79,6.97802893939394,67
"9313","WI-693034",2021,140,67,8.15845097222222,73
"9314","WI-693034",2022,131,89,6.60461536585366,42
"9315","WI-693034",2023,150,80,9.54831608695652,70
"9316","WI-693084",1979,189,103,13.2473815294118,86
"9317","WI-693084",1980,175,88,12.154401627907,87
"9318","WI-693084",1981,163,95,10.1715313432836,68
"9319","WI-693084",1982,184,102,13.5171033333333,82
"9320","WI-693084",1983,163,108,10.1671587037037,55
"9321","WI-693084",1984,157,93,9.46815412698413,64
"9322","WI-693084",1985,180,83,12.74793625,97
"9323","WI-693084",1986,149,84,10.5915778125,65
"9324","WI-693084",1987,148,92,11.9372438181818,56
"9325","WI-693084",1988,150,82,9.49253731343284,68
"9326","WI-693084",1989,171,82,10.6304229545455,89
"9327","WI-693084",1990,165,85,10.4554758227848,80
"9328","WI-693084",1991,133,75,7.8617501754386,58
"9329","WI-693084",1992,164,84,9.85646341772152,80
"9330","WI-693084",1993,185,81,10.9954408737864,104
"9331","WI-693084",1994,164,77,9.5226626744186,87
"9332","WI-693084",1995,166,97,10.8729997058824,69
"9333","WI-693084",1996,179,100,11.2074308974359,79
"9334","WI-693084",1997,171,101,10.8670208695652,70
"9335","WI-693084",1998,136,81,10.3127722222222,55
"9336","WI-693084",1999,156,74,10.3756845679012,82
"9337","WI-693084",2000,163,51,9.42256612612613,112
"9338","WI-693084",2001,161,87,11.3122426027397,74
"9339","WI-693084",2002,161,95,10.5445629230769,66
"9340","WI-693084",2003,167,97,12.0991576811594,70
"9341","WI-693084",2004,158,80,10.3570646753247,78
"9342","WI-693084",2005,155,82,10.43923625,73
"9343","WI-693084",2006,146,83,9.79659322580645,63
"9344","WI-693084",2007,151,100,13.0807836,51
"9345","WI-693084",2008,159,85,9.86396136986301,74
"9346","WI-693084",2009,168,73,9.65403840425532,95
"9347","WI-693084",2010,142,66,8.99583,76
"9348","WI-693084",2011,155,88,9.7834846969697,67
"9349","WI-693084",2012,168,67,12.5785687,101
"9350","WI-693084",2013,164,92,10.6517914084507,72
"9351","WI-693084",2014,155,87,9.86968865671642,68
"9352","WI-693084",2015,174,86,12.4641786206897,88
"9353","WI-693084",2016,145,65,7.55206696202532,80
"9354","WI-693084",2017,158,76,10.3660818518519,82
"9355","WI-693084",2018,144,108,12.4121242857143,36
"9356","WI-693084",2019,176,79,10.5919663541667,97
"9357","WI-693084",2020,146,79,6.97802893939394,67
"9358","WI-693084",2021,140,67,8.15845097222222,73
"9359","WI-693084",2022,131,89,6.60461536585366,42
"9360","WI-693084",2023,150,80,9.54831608695652,70
"9361","WI-693121",1979,189,103,13.2473815294118,86
"9362","WI-693121",1980,175,88,12.154401627907,87
"9363","WI-693121",1981,163,95,10.1715313432836,68
"9364","WI-693121",1982,184,102,13.5171033333333,82
"9365","WI-693121",1983,163,108,10.1671587037037,55
"9366","WI-693121",1984,157,93,9.46815412698413,64
"9367","WI-693121",1985,180,83,12.74793625,97
"9368","WI-693121",1986,149,84,10.5915778125,65
"9369","WI-693121",1987,148,92,11.9372438181818,56
"9370","WI-693121",1988,150,82,9.49253731343284,68
"9371","WI-693121",1989,171,82,10.6304229545455,89
"9372","WI-693121",1990,165,85,10.4554758227848,80
"9373","WI-693121",1991,133,75,7.8617501754386,58
"9374","WI-693121",1992,164,84,9.85646341772152,80
"9375","WI-693121",1993,185,81,10.9954408737864,104
"9376","WI-693121",1994,164,77,9.5226626744186,87
"9377","WI-693121",1995,166,97,10.8729997058824,69
"9378","WI-693121",1996,179,100,11.2074308974359,79
"9379","WI-693121",1997,171,101,10.8670208695652,70
"9380","WI-693121",1998,136,81,10.3127722222222,55
"9381","WI-693121",1999,156,74,10.3756845679012,82
"9382","WI-693121",2000,163,51,9.42256612612613,112
"9383","WI-693121",2001,161,87,11.3122426027397,74
"9384","WI-693121",2002,161,95,10.5445629230769,66
"9385","WI-693121",2003,167,97,12.0991576811594,70
"9386","WI-693121",2004,158,80,10.3570646753247,78
"9387","WI-693121",2005,155,82,10.43923625,73
"9388","WI-693121",2006,146,83,9.79659322580645,63
"9389","WI-693121",2007,151,100,13.0807836,51
"9390","WI-693121",2008,159,85,9.86396136986301,74
"9391","WI-693121",2009,168,73,9.65403840425532,95
"9392","WI-693121",2010,142,66,8.99583,76
"9393","WI-693121",2011,155,88,9.7834846969697,67
"9394","WI-693121",2012,168,67,12.5785687,101
"9395","WI-693121",2013,164,92,10.6517914084507,72
"9396","WI-693121",2014,155,87,9.86968865671642,68
"9397","WI-693121",2015,174,86,12.4641786206897,88
"9398","WI-693121",2016,145,65,7.55206696202532,80
"9399","WI-693121",2017,158,76,10.3660818518519,82
"9400","WI-693121",2018,144,108,12.4121242857143,36
"9401","WI-693121",2019,176,79,10.5919663541667,97
"9402","WI-693121",2020,146,79,6.97802893939394,67
"9403","WI-693121",2021,140,67,8.15845097222222,73
"9404","WI-693121",2022,131,89,6.60461536585366,42
"9405","WI-693121",2023,150,80,9.54831608695652,70
"9406","WI-703014",1979,169,102,12.2813103030303,67
"9407","WI-703014",1980,175,88,12.4503677906977,87
"9408","WI-703014",1981,163,84,9.70222217948718,79
"9409","WI-703014",1982,184,102,13.6285035802469,82
"9410","WI-703014",1983,162,108,10.3597575471698,54
"9411","WI-703014",1984,157,92,9.8043940625,65
"9412","WI-703014",1985,179,82,13.1119465625,97
"9413","WI-703014",1986,149,83,10.8750064615385,66
"9414","WI-703014",1987,148,92,12.2841190909091,56
"9415","WI-703014",1988,150,81,9.69677764705882,69
"9416","WI-703014",1989,171,82,11.2132532954545,89
"9417","WI-703014",1990,163,85,10.447564025974,78
"9418","WI-703014",1991,133,74,8.19260551724138,59
"9419","WI-703014",1992,164,84,10.1967518987342,80
"9420","WI-703014",1993,185,81,11.3773429126214,104
"9421","WI-703014",1994,164,76,9.79238275862069,88
"9422","WI-703014",1995,155,97,9.98280368421053,58
"9423","WI-703014",1996,178,98,11.309063164557,80
"9424","WI-703014",1997,170,101,11.1632779411765,69
"9425","WI-703014",1998,136,81,10.6281651851852,55
"9426","WI-703014",1999,156,74,10.650472345679,82
"9427","WI-703014",2000,161,51,9.49925871559633,110
"9428","WI-703014",2001,161,87,11.7077909589041,74
"9429","WI-703014",2002,160,94,10.7604621538462,66
"9430","WI-703014",2003,167,97,12.4070150724638,70
"9431","WI-703014",2004,158,80,11.0174744155844,78
"9432","WI-703014",2005,155,81,10.5993375342466,74
"9433","WI-703014",2006,146,83,10.0488617741935,63
"9434","WI-703014",2007,151,100,13.4818772,51
"9435","WI-703014",2008,157,85,9.88830338028169,72
"9436","WI-703014",2009,168,73,9.99313425531915,95
"9437","WI-703014",2010,142,66,9.29541253333333,76
"9438","WI-703014",2011,153,88,10.089225625,65
"9439","WI-703014",2012,168,66,12.9556092079208,102
"9440","WI-703014",2013,164,86,10.2855128571429,78
"9441","WI-703014",2014,150,86,9.44193984126984,64
"9442","WI-703014",2015,168,86,12.4030381481481,82
"9443","WI-703014",2016,145,64,7.901938125,81
"9444","WI-703014",2017,158,76,10.7883428395062,82
"9445","WI-703014",2018,145,108,12.9807011111111,37
"9446","WI-703014",2019,175,74,10.5185863,101
"9447","WI-703014",2020,146,68,6.65391207792208,78
"9448","WI-703014",2021,140,66,8.3683201369863,74
"9449","WI-703014",2022,131,89,7.19703048780488,42
"9450","WI-703014",2023,150,77,9.38392194444445,73
"9451","WI-703018",1979,169,102,12.2813103030303,67
"9452","WI-703018",1980,175,88,12.4503677906977,87
"9453","WI-703018",1981,163,84,9.70222217948718,79
"9454","WI-703018",1982,184,102,13.6285035802469,82
"9455","WI-703018",1983,162,108,10.3597575471698,54
"9456","WI-703018",1984,157,92,9.8043940625,65
"9457","WI-703018",1985,179,82,13.1119465625,97
"9458","WI-703018",1986,149,83,10.8750064615385,66
"9459","WI-703018",1987,148,92,12.2841190909091,56
"9460","WI-703018",1988,150,81,9.69677764705882,69
"9461","WI-703018",1989,171,82,11.2132532954545,89
"9462","WI-703018",1990,163,85,10.447564025974,78
"9463","WI-703018",1991,133,74,8.19260551724138,59
"9464","WI-703018",1992,164,84,10.1967518987342,80
"9465","WI-703018",1993,185,81,11.3773429126214,104
"9466","WI-703018",1994,164,76,9.79238275862069,88
"9467","WI-703018",1995,155,97,9.98280368421053,58
"9468","WI-703018",1996,178,98,11.309063164557,80
"9469","WI-703018",1997,170,101,11.1632779411765,69
"9470","WI-703018",1998,136,81,10.6281651851852,55
"9471","WI-703018",1999,156,74,10.650472345679,82
"9472","WI-703018",2000,161,51,9.49925871559633,110
"9473","WI-703018",2001,161,87,11.7077909589041,74
"9474","WI-703018",2002,160,94,10.7604621538462,66
"9475","WI-703018",2003,167,97,12.4070150724638,70
"9476","WI-703018",2004,158,80,11.0174744155844,78
"9477","WI-703018",2005,155,81,10.5993375342466,74
"9478","WI-703018",2006,146,83,10.0488617741935,63
"9479","WI-703018",2007,151,100,13.4818772,51
"9480","WI-703018",2008,157,85,9.88830338028169,72
"9481","WI-703018",2009,168,73,9.99313425531915,95
"9482","WI-703018",2010,142,66,9.29541253333333,76
"9483","WI-703018",2011,153,88,10.089225625,65
"9484","WI-703018",2012,168,66,12.9556092079208,102
"9485","WI-703018",2013,164,86,10.2855128571429,78
"9486","WI-703018",2014,150,86,9.44193984126984,64
"9487","WI-703018",2015,168,86,12.4030381481481,82
"9488","WI-703018",2016,145,64,7.901938125,81
"9489","WI-703018",2017,158,76,10.7883428395062,82
"9490","WI-703018",2018,145,108,12.9807011111111,37
"9491","WI-703018",2019,175,74,10.5185863,101
"9492","WI-703018",2020,146,68,6.65391207792208,78
"9493","WI-703018",2021,140,66,8.3683201369863,74
"9494","WI-703018",2022,131,89,7.19703048780488,42
"9495","WI-703018",2023,150,77,9.38392194444445,73
"9496","WI-703027",1979,169,102,12.2813103030303,67
"9497","WI-703027",1980,175,88,12.4503677906977,87
"9498","WI-703027",1981,163,84,9.70222217948718,79
"9499","WI-703027",1982,184,102,13.6285035802469,82
"9500","WI-703027",1983,162,108,10.3597575471698,54
"9501","WI-703027",1984,157,92,9.8043940625,65
"9502","WI-703027",1985,179,82,13.1119465625,97
"9503","WI-703027",1986,149,83,10.8750064615385,66
"9504","WI-703027",1987,148,92,12.2841190909091,56
"9505","WI-703027",1988,150,81,9.69677764705882,69
"9506","WI-703027",1989,171,82,11.2132532954545,89
"9507","WI-703027",1990,163,85,10.447564025974,78
"9508","WI-703027",1991,133,74,8.19260551724138,59
"9509","WI-703027",1992,164,84,10.1967518987342,80
"9510","WI-703027",1993,185,81,11.3773429126214,104
"9511","WI-703027",1994,164,76,9.79238275862069,88
"9512","WI-703027",1995,155,97,9.98280368421053,58
"9513","WI-703027",1996,178,98,11.309063164557,80
"9514","WI-703027",1997,170,101,11.1632779411765,69
"9515","WI-703027",1998,136,81,10.6281651851852,55
"9516","WI-703027",1999,156,74,10.650472345679,82
"9517","WI-703027",2000,161,51,9.49925871559633,110
"9518","WI-703027",2001,161,87,11.7077909589041,74
"9519","WI-703027",2002,160,94,10.7604621538462,66
"9520","WI-703027",2003,167,97,12.4070150724638,70
"9521","WI-703027",2004,158,80,11.0174744155844,78
"9522","WI-703027",2005,155,81,10.5993375342466,74
"9523","WI-703027",2006,146,83,10.0488617741935,63
"9524","WI-703027",2007,151,100,13.4818772,51
"9525","WI-703027",2008,157,85,9.88830338028169,72
"9526","WI-703027",2009,168,73,9.99313425531915,95
"9527","WI-703027",2010,142,66,9.29541253333333,76
"9528","WI-703027",2011,153,88,10.089225625,65
"9529","WI-703027",2012,168,66,12.9556092079208,102
"9530","WI-703027",2013,164,86,10.2855128571429,78
"9531","WI-703027",2014,150,86,9.44193984126984,64
"9532","WI-703027",2015,168,86,12.4030381481481,82
"9533","WI-703027",2016,145,64,7.901938125,81
"9534","WI-703027",2017,158,76,10.7883428395062,82
"9535","WI-703027",2018,145,108,12.9807011111111,37
"9536","WI-703027",2019,175,74,10.5185863,101
"9537","WI-703027",2020,146,68,6.65391207792208,78
"9538","WI-703027",2021,140,66,8.3683201369863,74
"9539","WI-703027",2022,131,89,7.19703048780488,42
"9540","WI-703027",2023,150,77,9.38392194444445,73
"9541","WI-703031",1979,169,102,12.2813103030303,67
"9542","WI-703031",1980,175,88,12.4503677906977,87
"9543","WI-703031",1981,163,84,9.70222217948718,79
"9544","WI-703031",1982,184,102,13.6285035802469,82
"9545","WI-703031",1983,162,108,10.3597575471698,54
"9546","WI-703031",1984,157,92,9.8043940625,65
"9547","WI-703031",1985,179,82,13.1119465625,97
"9548","WI-703031",1986,149,83,10.8750064615385,66
"9549","WI-703031",1987,148,92,12.2841190909091,56
"9550","WI-703031",1988,150,81,9.69677764705882,69
"9551","WI-703031",1989,171,82,11.2132532954545,89
"9552","WI-703031",1990,163,85,10.447564025974,78
"9553","WI-703031",1991,133,74,8.19260551724138,59
"9554","WI-703031",1992,164,84,10.1967518987342,80
"9555","WI-703031",1993,185,81,11.3773429126214,104
"9556","WI-703031",1994,164,76,9.79238275862069,88
"9557","WI-703031",1995,155,97,9.98280368421053,58
"9558","WI-703031",1996,178,98,11.309063164557,80
"9559","WI-703031",1997,170,101,11.1632779411765,69
"9560","WI-703031",1998,136,81,10.6281651851852,55
"9561","WI-703031",1999,156,74,10.650472345679,82
"9562","WI-703031",2000,161,51,9.49925871559633,110
"9563","WI-703031",2001,161,87,11.7077909589041,74
"9564","WI-703031",2002,160,94,10.7604621538462,66
"9565","WI-703031",2003,167,97,12.4070150724638,70
"9566","WI-703031",2004,158,80,11.0174744155844,78
"9567","WI-703031",2005,155,81,10.5993375342466,74
"9568","WI-703031",2006,146,83,10.0488617741935,63
"9569","WI-703031",2007,151,100,13.4818772,51
"9570","WI-703031",2008,157,85,9.88830338028169,72
"9571","WI-703031",2009,168,73,9.99313425531915,95
"9572","WI-703031",2010,142,66,9.29541253333333,76
"9573","WI-703031",2011,153,88,10.089225625,65
"9574","WI-703031",2012,168,66,12.9556092079208,102
"9575","WI-703031",2013,164,86,10.2855128571429,78
"9576","WI-703031",2014,150,86,9.44193984126984,64
"9577","WI-703031",2015,168,86,12.4030381481481,82
"9578","WI-703031",2016,145,64,7.901938125,81
"9579","WI-703031",2017,158,76,10.7883428395062,82
"9580","WI-703031",2018,145,108,12.9807011111111,37
"9581","WI-703031",2019,175,74,10.5185863,101
"9582","WI-703031",2020,146,68,6.65391207792208,78
"9583","WI-703031",2021,140,66,8.3683201369863,74
"9584","WI-703031",2022,131,89,7.19703048780488,42
"9585","WI-703031",2023,150,77,9.38392194444445,73
"9586","WI-703052",1979,169,102,12.2813103030303,67
"9587","WI-703052",1980,175,88,12.4503677906977,87
"9588","WI-703052",1981,163,84,9.70222217948718,79
"9589","WI-703052",1982,184,102,13.6285035802469,82
"9590","WI-703052",1983,162,108,10.3597575471698,54
"9591","WI-703052",1984,157,92,9.8043940625,65
"9592","WI-703052",1985,179,82,13.1119465625,97
"9593","WI-703052",1986,149,83,10.8750064615385,66
"9594","WI-703052",1987,148,92,12.2841190909091,56
"9595","WI-703052",1988,150,81,9.69677764705882,69
"9596","WI-703052",1989,171,82,11.2132532954545,89
"9597","WI-703052",1990,163,85,10.447564025974,78
"9598","WI-703052",1991,133,74,8.19260551724138,59
"9599","WI-703052",1992,164,84,10.1967518987342,80
"9600","WI-703052",1993,185,81,11.3773429126214,104
"9601","WI-703052",1994,164,76,9.79238275862069,88
"9602","WI-703052",1995,155,97,9.98280368421053,58
"9603","WI-703052",1996,178,98,11.309063164557,80
"9604","WI-703052",1997,170,101,11.1632779411765,69
"9605","WI-703052",1998,136,81,10.6281651851852,55
"9606","WI-703052",1999,156,74,10.650472345679,82
"9607","WI-703052",2000,161,51,9.49925871559633,110
"9608","WI-703052",2001,161,87,11.7077909589041,74
"9609","WI-703052",2002,160,94,10.7604621538462,66
"9610","WI-703052",2003,167,97,12.4070150724638,70
"9611","WI-703052",2004,158,80,11.0174744155844,78
"9612","WI-703052",2005,155,81,10.5993375342466,74
"9613","WI-703052",2006,146,83,10.0488617741935,63
"9614","WI-703052",2007,151,100,13.4818772,51
"9615","WI-703052",2008,157,85,9.88830338028169,72
"9616","WI-703052",2009,168,73,9.99313425531915,95
"9617","WI-703052",2010,142,66,9.29541253333333,76
"9618","WI-703052",2011,153,88,10.089225625,65
"9619","WI-703052",2012,168,66,12.9556092079208,102
"9620","WI-703052",2013,164,86,10.2855128571429,78
"9621","WI-703052",2014,150,86,9.44193984126984,64
"9622","WI-703052",2015,168,86,12.4030381481481,82
"9623","WI-703052",2016,145,64,7.901938125,81
"9624","WI-703052",2017,158,76,10.7883428395062,82
"9625","WI-703052",2018,145,108,12.9807011111111,37
"9626","WI-703052",2019,175,74,10.5185863,101
"9627","WI-703052",2020,146,68,6.65391207792208,78
"9628","WI-703052",2021,140,66,8.3683201369863,74
"9629","WI-703052",2022,131,89,7.19703048780488,42
"9630","WI-703052",2023,150,77,9.38392194444445,73
"9631","WI-703056",1979,169,102,12.2813103030303,67
"9632","WI-703056",1980,175,88,12.4503677906977,87
"9633","WI-703056",1981,163,84,9.70222217948718,79
"9634","WI-703056",1982,184,102,13.6285035802469,82
"9635","WI-703056",1983,162,108,10.3597575471698,54
"9636","WI-703056",1984,157,92,9.8043940625,65
"9637","WI-703056",1985,179,82,13.1119465625,97
"9638","WI-703056",1986,149,83,10.8750064615385,66
"9639","WI-703056",1987,148,92,12.2841190909091,56
"9640","WI-703056",1988,150,81,9.69677764705882,69
"9641","WI-703056",1989,171,82,11.2132532954545,89
"9642","WI-703056",1990,163,85,10.447564025974,78
"9643","WI-703056",1991,133,74,8.19260551724138,59
"9644","WI-703056",1992,164,84,10.1967518987342,80
"9645","WI-703056",1993,185,81,11.3773429126214,104
"9646","WI-703056",1994,164,76,9.79238275862069,88
"9647","WI-703056",1995,155,97,9.98280368421053,58
"9648","WI-703056",1996,178,98,11.309063164557,80
"9649","WI-703056",1997,170,101,11.1632779411765,69
"9650","WI-703056",1998,136,81,10.6281651851852,55
"9651","WI-703056",1999,156,74,10.650472345679,82
"9652","WI-703056",2000,161,51,9.49925871559633,110
"9653","WI-703056",2001,161,87,11.7077909589041,74
"9654","WI-703056",2002,160,94,10.7604621538462,66
"9655","WI-703056",2003,167,97,12.4070150724638,70
"9656","WI-703056",2004,158,80,11.0174744155844,78
"9657","WI-703056",2005,155,81,10.5993375342466,74
"9658","WI-703056",2006,146,83,10.0488617741935,63
"9659","WI-703056",2007,151,100,13.4818772,51
"9660","WI-703056",2008,157,85,9.88830338028169,72
"9661","WI-703056",2009,168,73,9.99313425531915,95
"9662","WI-703056",2010,142,66,9.29541253333333,76
"9663","WI-703056",2011,153,88,10.089225625,65
"9664","WI-703056",2012,168,66,12.9556092079208,102
"9665","WI-703056",2013,164,86,10.2855128571429,78
"9666","WI-703056",2014,150,86,9.44193984126984,64
"9667","WI-703056",2015,168,86,12.4030381481481,82
"9668","WI-703056",2016,145,64,7.901938125,81
"9669","WI-703056",2017,158,76,10.7883428395062,82
"9670","WI-703056",2018,145,108,12.9807011111111,37
"9671","WI-703056",2019,175,74,10.5185863,101
"9672","WI-703056",2020,146,68,6.65391207792208,78
"9673","WI-703056",2021,140,66,8.3683201369863,74
"9674","WI-703056",2022,131,89,7.19703048780488,42
"9675","WI-703056",2023,150,77,9.38392194444445,73
"9676","WI-713244",1979,169,102,12.0773575757576,67
"9677","WI-713244",1980,175,89,12.3006089411765,86
"9678","WI-713244",1981,163,85,9.32743272727273,78
"9679","WI-713244",1982,184,102,13.6588854320988,82
"9680","WI-713244",1983,162,109,9.96985173076923,53
"9681","WI-713244",1984,157,93,9.71964190476191,64
"9682","WI-713244",1985,180,83,12.9781598958333,97
"9683","WI-713244",1986,149,83,10.5875066153846,66
"9684","WI-713244",1987,148,92,11.8775843636364,56
"9685","WI-713244",1988,150,81,9.58464544117647,69
"9686","WI-713244",1989,171,82,11.1810268181818,89
"9687","WI-713244",1990,163,85,10.3265211688312,78
"9688","WI-713244",1991,133,74,8.24163448275862,59
"9689","WI-713244",1992,166,84,10.3707561728395,82
"9690","WI-713244",1993,184,81,11.2101645098039,103
"9691","WI-713244",1994,164,76,9.56923333333333,88
"9692","WI-713244",1995,166,97,11.0640616176471,69
"9693","WI-713244",1996,179,99,11.422882278481,80
"9694","WI-713244",1997,171,101,10.9607708695652,70
"9695","WI-713244",1998,136,81,10.2948324074074,55
"9696","WI-713244",1999,156,74,10.49808,82
"9697","WI-713244",2000,162,51,9.67482981818182,111
"9698","WI-713244",2001,161,87,11.7099317808219,74
"9699","WI-713244",2002,160,94,10.7335390769231,66
"9700","WI-713244",2003,173,97,12.6507030666667,76
"9701","WI-713244",2004,158,80,10.9044472727273,78
"9702","WI-713244",2005,155,81,10.5842482191781,74
"9703","WI-713244",2006,146,82,9.9402953968254,64
"9704","WI-713244",2007,150,100,13.1160818367347,50
"9705","WI-713244",2008,157,86,9.96654471428571,71
"9706","WI-713244",2009,168,73,9.86447712765957,95
"9707","WI-713244",2010,142,66,9.20437053333333,76
"9708","WI-713244",2011,153,88,9.97533375,65
"9709","WI-713244",2012,168,63,12.4036267307692,105
"9710","WI-713244",2013,164,86,10.2830779220779,78
"9711","WI-713244",2014,150,86,9.53395380952381,64
"9712","WI-713244",2015,168,86,12.4282112345679,82
"9713","WI-713244",2016,145,64,7.6753765,81
"9714","WI-713244",2017,160,77,10.8763129268293,83
"9715","WI-713244",2018,145,108,12.7419863888889,37
"9716","WI-713244",2019,176,73,10.3552869607843,103
"9717","WI-713244",2020,146,68,6.50598181818182,78
"9718","WI-713244",2021,140,66,8.34616753424658,74
"9719","WI-713244",2022,131,89,7.21589609756098,42
"9720","WI-713244",2023,150,77,9.41972958333333,73
"9721","aba01",1979,190,124,9.44703830769231,66
"9722","aba01",1980,175,107,10.9519379104478,68
"9723","aba01",1981,185,97,10.8105272413793,88
"9724","aba01",1982,187,102,12.0194495238095,85
"9725","aba01",1983,173,110,10.2862322580645,63
"9726","aba01",1984,193,101,11.0820476923077,92
"9727","aba01",1985,NA,99,NA,NA
"9728","aba01",1986,188,86,11.3826465346535,102
"9729","aba01",1987,150,93,11.1044671428571,57
"9730","aba01",1988,150,89,8.621971,61
"9731","aba01",1989,184,102,11.4527172839506,82
"9732","aba01",1990,182,100,11.8683607407407,82
"9733","aba01",1991,177,91,12.5519028235294,86
"9734","aba01",1992,NA,105,NA,NA
"9735","aba01",1993,223,94,12.071902578125,129
"9736","aba01",1994,166,96,9.52927594202898,70
"9737","aba01",1995,167,99,8.83434059701493,68
"9738","aba01",1996,181,106,9.98943594594595,75
"9739","aba01",1997,174,104,9.50023768115942,70
"9740","aba01",1998,176,82,11.5029579569892,94
"9741","aba01",1999,158,86,9.85295478873239,72
"9742","aba01",2000,225,78,12.2486180821918,147
"9743","aba01",2001,163,89,9.7114401369863,74
"9744","aba01",2002,173,97,9.528742,76
"9745","aba01",2003,184,98,12.0026769411765,86
"9746","aba01",2004,195,93,10.8013508910891,102
"9747","aba01",2005,159,85,9.51996301369863,74
"9748","aba01",2006,147,86,8.50117516666667,61
"9749","aba01",2007,163,101,12.7886521311475,62
"9750","aba01",2008,199,103,12.4028904210526,96
"9751","aba01",2009,170,99,10.0155901428571,71
"9752","aba01",2010,142,86,8.77634581818182,56
"9753","aba01",2011,180,108,11.8676670422535,72
"9754","aba01",2012,170,69,10.1651256,101
"9755","aba01",2013,174,109,11.70137296875,65
"9756","aba01",2014,178,107,12.2343052857143,71
"9757","aba01",2015,193,88,11.9076761538462,105
"9758","aba01",2016,190,102,13.6465120689655,88
"9759","aba01",2017,162,83,9.18997538461539,79
"9760","aba01",2018,145,109,10.9228385714286,36
"9761","aba01",2019,179,103,10.7527321333333,76
"9762","aba01",2020,179,110,12.0052345588235,69
"9763","aba01",2021,155,77,8.15816207792208,78
"9764","aba01",2022,169,109,11.8947255932203,60
"9765","aba01",2023,151,97,9.86065377358491,54
